id,Year,Team,G,MP,FG,FGA,FG_Perc,3P,3PA,3P_Perc,2P,2PA,2P_Perc,FT,FTA,FT_Perc,ORB,DRB,TRB,AST,STL,BLK,TOV,PF,PTS,Points_per_Minute,Playoff
1,1980,San Antonio Spurs*,82,19755,3856,7738,0.498,52,206,0.252,3804,7532,0.505,2024,2528,0.801,1153,2515,3668,2326,771,333,1589,2103,9788,0.495470,1
2,1980,Los Angeles Lakers*,82,19880,3898,7368,0.529,20,100,0.2,3878,7268,0.534,1622,2092,0.775,1085,2653,3738,2413,774,546,1639,1784,9438,0.474748,1
3,1980,Cleveland Cavaliers,82,19930,3811,8041,0.474,36,187,0.193,3775,7854,0.481,1702,2205,0.772,1307,2381,3688,2108,764,342,1370,1934,9360,0.469644,0
4,1980,New York Knicks,82,19780,3802,7672,0.496,42,191,0.22,3760,7481,0.503,1698,2274,0.747,1236,2303,3539,2265,881,457,1613,2168,9344,0.472396,0
5,1980,Boston Celtics*,82,19880,3617,7387,0.49,162,422,0.384,3455,6965,0.496,1907,2449,0.779,1227,2457,3684,2198,809,308,1539,1974,9303,0.467958,1
6,1980,Indiana Pacers,82,19855,3639,7689,0.473,88,314,0.28,3551,7375,0.481,1753,2333,0.751,1398,2326,3724,2148,900,530,1517,1973,9119,0.459280,0
7,1980,Phoenix Suns*,82,19755,3570,7235,0.493,68,280,0.243,3502,6955,0.504,1906,2466,0.773,1071,2458,3529,2283,908,344,1629,1853,9114,0.461352,1
8,1980,Houston Rockets*,82,19930,3599,7496,0.48,104,379,0.274,3495,7117,0.491,1782,2326,0.766,1394,2217,3611,2149,782,373,1565,1927,9084,0.455795,1
9,1980,Milwaukee Bucks*,82,19805,3685,7553,0.488,50,155,0.323,3635,7398,0.491,1605,2102,0.764,1245,2396,3641,2277,778,510,1496,1937,9025,0.455693,1
10,1980,Philadelphia 76ers*,82,19855,3523,7156,0.492,27,125,0.216,3496,7031,0.497,1876,2431,0.772,1187,2635,3822,2226,792,652,1708,1860,8949,0.450718,1
11,1980,Detroit Pistons,82,19780,3643,7596,0.48,57,219,0.26,3586,7377,0.486,1590,2149,0.74,1226,2415,3641,1950,783,562,1742,2069,8933,0.451618,0
12,1980,Seattle SuperSonics*,82,19830,3554,7565,0.47,59,189,0.312,3495,7376,0.474,1730,2253,0.768,1380,2550,3930,2043,750,428,1496,1865,8897,0.448664,1
13,1980,New Jersey Nets,82,19805,3456,7504,0.461,85,298,0.285,3371,7206,0.468,1882,2406,0.782,1229,2535,3764,2094,869,581,1702,2181,8879,0.448321,0
14,1980,Denver Nuggets,82,19830,3462,7470,0.463,83,255,0.325,3379,7215,0.468,1871,2539,0.737,1311,2524,3835,2079,746,404,1533,1917,8878,0.447705,0
15,1980,Kansas City Kings*,82,19805,3582,7489,0.478,25,114,0.219,3557,7375,0.482,1671,2250,0.743,1187,2429,3616,2123,863,356,1439,2135,8860,0.447362,1
16,1980,San Diego Clippers,82,19755,3524,7494,0.47,177,543,0.326,3347,6951,0.482,1595,2167,0.736,1294,2308,3602,1688,664,288,1443,1896,8820,0.446469,0
17,1980,Chicago Bulls,82,19905,3362,6943,0.484,70,275,0.255,3292,6668,0.494,2019,2592,0.779,1115,2465,3580,2152,704,392,1684,2146,8813,0.442753,0
18,1980,Washington Bullets*,82,19880,3574,7796,0.458,73,238,0.307,3501,7558,0.463,1552,2048,0.758,1334,2723,4057,2201,530,443,1380,1893,8773,0.441298,1
19,1980,Atlanta Hawks*,82,19780,3261,7027,0.464,13,75,0.173,3248,6952,0.467,2038,2645,0.771,1369,2406,3775,1913,782,539,1495,2293,8573,0.433418,1
20,1980,Golden State Warriors,82,19880,3527,7318,0.482,27,121,0.223,3500,7197,0.486,1412,1914,0.738,1155,2437,3592,2028,779,339,1492,2082,8493,0.427213,0
21,1980,Portland Trail Blazers*,82,19780,3408,7167,0.476,26,132,0.197,3382,7035,0.481,1560,2100,0.743,1295,2408,3703,1898,708,472,1552,1956,8402,0.424772,1
22,1980,Utah Jazz,82,19805,3382,6817,0.496,59,185,0.319,3323,6632,0.501,1571,1943,0.809,967,2359,3326,2005,656,362,1543,2006,8394,0.004191,0
23,1981,Denver Nuggets,82,19955,3784,7960,0.475,30,145,0.207,3754,7815,0.48,2388,3051,0.783,1325,2497,3822,2030,720,380,1444,2108,9986,0.500426,0
24,1981,Milwaukee Bucks*,82,19755,3722,7472,0.498,30,131,0.229,3692,7341,0.503,1802,2340,0.77,1261,2408,3669,2319,862,530,1581,2198,9276,0.469552,1
25,1981,San Antonio Spurs*,82,19805,3571,7276,0.491,15,85,0.176,3556,7191,0.495,2052,2668,0.769,1304,2582,3886,2048,685,643,1533,2114,9209,0.464984,1
26,1981,Philadelphia 76ers*,82,19855,3636,7073,0.514,19,84,0.226,3617,6989,0.518,1865,2427,0.768,1091,2618,3709,2369,857,591,1702,2061,9156,0.461143,1
27,1981,Los Angeles Lakers*,82,19805,3780,7382,0.512,17,94,0.181,3763,7288,0.516,1540,2113,0.729,1165,2491,3656,2363,808,551,1557,1955,9117,0.460338,1
28,1981,Portland Trail Blazers*,82,19855,3741,7535,0.496,25,148,0.169,3716,7387,0.503,1573,2191,0.718,1243,2388,3631,2244,769,480,1518,2034,9080,0.457316,1
29,1981,Phoenix Suns*,82,19755,3587,7326,0.49,35,161,0.217,3552,7165,0.496,1810,2430,0.745,1234,2490,3724,2205,876,416,1733,1996,9019,0.456543,1
30,1981,Boston Celtics*,82,19780,3581,7099,0.504,65,241,0.27,3516,6858,0.513,1781,2369,0.752,1155,2424,3579,2202,683,594,1577,1990,9008,0.455410,1
31,1981,Golden State Warriors,82,19730,3560,7284,0.489,60,210,0.286,3500,7074,0.495,1826,2513,0.727,1403,2366,3769,2026,611,301,1547,2158,9006,0.456462,0
32,1981,Chicago Bulls*,82,19780,3457,6903,0.501,38,179,0.212,3419,6724,0.508,1985,2563,0.774,1227,2475,3702,1925,729,514,1672,2058,8937,0.451820,1
33,1981,Houston Rockets*,82,19805,3573,7335,0.487,21,118,0.178,3552,7217,0.492,1711,2223,0.77,1216,2347,3563,2099,705,390,1451,1901,8878,0.448271,1
34,1981,New York Knicks*,82,19830,3505,7255,0.483,56,236,0.237,3449,7019,0.491,1783,2386,0.747,1137,2205,3342,1976,861,314,1461,1917,8849,0.446243,1
35,1981,Indiana Pacers*,82,19730,3491,7245,0.482,30,169,0.178,3461,7076,0.489,1815,2540,0.715,1325,2267,3592,2091,833,484,1491,2006,8827,0.447390,1
36,1981,Kansas City Kings*,82,19830,3572,7151,0.5,49,168,0.292,3523,6983,0.505,1576,2206,0.714,1037,2450,3487,2271,719,385,1448,2092,8769,0.442209,1
37,1981,New Jersey Nets,82,19805,3477,7314,0.475,34,138,0.246,3443,7176,0.48,1780,2371,0.751,1092,2374,3466,2068,750,458,1664,2204,8768,0.442716,0
38,1981,San Diego Clippers,82,19730,3477,7283,0.477,132,407,0.324,3345,6876,0.486,1651,2246,0.735,1169,2144,3313,2098,764,292,1407,2078,8737,0.442828,0
39,1981,Cleveland Cavaliers,82,19780,3556,7609,0.467,72,249,0.289,3484,7360,0.473,1486,1909,0.778,1258,2243,3501,2007,632,322,1396,1995,8670,0.438322,0
40,1981,Washington Bullets,82,19780,3549,7517,0.472,65,241,0.27,3484,7276,0.479,1499,2072,0.723,1155,2533,3688,2151,641,392,1422,1895,8662,0.437917,0
41,1981,Atlanta Hawks,82,19930,3291,6866,0.479,10,82,0.122,3281,6784,0.484,2012,2590,0.777,1201,2224,3425,1846,749,469,1605,2276,8604,0.431711,0
42,1981,Seattle SuperSonics,82,19780,3343,7145,0.468,32,117,0.274,3311,7028,0.471,1813,2376,0.763,1167,2434,3601,1945,628,438,1524,1986,8531,0.431294,0
43,1981,Dallas Mavericks,82,19780,3204,6928,0.462,46,165,0.279,3158,6763,0.467,1868,2487,0.751,1109,2177,3286,1984,561,214,1439,2008,8322,0.420728,0
44,1981,Utah Jazz,82,19730,3332,6825,0.488,42,163,0.258,3290,6662,0.494,1595,2080,0.767,962,2325,3287,1948,637,386,1423,2110,8301,0.420730,0
45,1981,Detroit Pistons,82,19755,3236,6986,0.463,13,84,0.155,3223,6902,0.467,1689,2330,0.725,1201,2111,3312,1819,884,492,1759,2125,8174,0.413769,0
46,1982,Denver Nuggets*,82,19830,3980,7656,0.52,40,149,0.268,3940,7507,0.525,2371,2978,0.796,1149,2443,3592,2272,664,368,1470,2131,10371,0.522995,1
47,1982,Los Angeles Lakers*,82,19855,3919,7585,0.517,13,94,0.138,3906,7491,0.521,1549,2161,0.717,1258,2505,3763,2356,848,517,1468,1999,9400,0.473432,1
48,1982,San Antonio Spurs*,82,19755,3698,7613,0.486,64,252,0.254,3634,7361,0.494,1812,2335,0.776,1253,2537,3790,2257,600,555,1293,2217,9272,0.469350,1
49,1982,Boston Celtics*,82,19780,3657,7334,0.499,49,184,0.266,3608,7150,0.505,1817,2457,0.74,1253,2489,3742,2126,652,568,1452,2014,9180,0.464105,1
50,1982,Philadelphia 76ers*,82,19855,3616,6974,0.518,41,139,0.295,3575,6835,0.523,1846,2471,0.747,1031,2389,3420,2264,856,622,1474,2183,9119,0.459280,1
51,1982,Detroit Pistons,82,19830,3561,7391,0.482,52,213,0.244,3509,7178,0.489,1938,2581,0.751,1298,2345,3643,2027,741,564,1629,2160,9112,0.459506,0
52,1982,Utah Jazz,82,19780,3679,7446,0.494,22,97,0.227,3657,7349,0.498,1714,2282,0.751,1147,2362,3509,1895,700,357,1435,2196,9094,0.459757,0
53,1982,Golden State Warriors,82,19780,3646,7349,0.496,91,325,0.28,3555,7024,0.506,1709,2382,0.717,1282,2452,3734,1820,685,391,1424,2225,9092,0.459656,0
54,1982,Portland Trail Blazers,82,19780,3629,7187,0.505,29,140,0.207,3600,7047,0.511,1719,2387,0.72,1142,2355,3497,2054,706,367,1390,2012,9006,0.455308,0
55,1982,San Diego Clippers,82,19755,3552,7101,0.5,99,338,0.293,3453,6763,0.511,1693,2341,0.723,1131,2196,3327,1878,636,299,1570,2353,8896,0.450316,0
56,1982,Milwaukee Bucks*,82,19805,3544,7015,0.505,49,164,0.299,3495,6851,0.51,1753,2329,0.753,1167,2415,3582,2233,763,455,1589,2281,8890,0.448877,1
57,1982,Seattle SuperSonics*,82,19830,3505,7178,0.488,38,153,0.248,3467,7025,0.494,1747,2362,0.74,1103,2544,3647,2103,691,460,1351,2057,8795,0.443520,1
58,1982,Kansas City Kings,82,19880,3604,7284,0.495,26,130,0.2,3578,7154,0.5,1551,2158,0.719,1086,2276,3362,2056,743,402,1507,2359,8785,0.441901,0
59,1982,New Jersey Nets*,82,19780,3501,7227,0.484,30,146,0.205,3471,7081,0.49,1714,2354,0.728,1194,2320,3514,2096,918,481,1650,2295,8746,0.442164,1
60,1982,Chicago Bulls,82,19880,3369,6728,0.501,54,213,0.254,3315,6515,0.509,1951,2545,0.767,1125,2525,3650,2043,580,483,1636,2008,8743,0.439789,0
61,1982,New York Knicks,82,19830,3523,7178,0.491,58,214,0.271,3465,6964,0.498,1603,2171,0.738,1168,2273,3441,2075,719,338,1486,2195,8707,0.439082,0
62,1982,Phoenix Suns*,82,19830,3508,7140,0.491,54,174,0.31,3454,6966,0.496,1635,2157,0.758,1123,2517,3640,2223,753,429,1528,2029,8705,0.438981,1
63,1982,Houston Rockets*,82,19780,3504,7366,0.476,50,176,0.284,3454,7190,0.48,1622,2225,0.729,1403,2284,3687,1977,648,429,1321,1871,8680,0.438827,1
64,1982,Dallas Mavericks,82,19730,3390,7224,0.469,55,190,0.289,3335,7034,0.474,1740,2366,0.735,1213,2228,3441,2117,566,313,1317,2193,8575,0.434617,0
65,1982,Washington Bullets*,82,19830,3400,7168,0.474,59,236,0.25,3341,6932,0.482,1626,2105,0.772,1047,2583,3630,1983,643,397,1390,2072,8485,0.427887,1
66,1982,Cleveland Cavaliers,82,19805,3405,7334,0.464,25,137,0.182,3380,7197,0.47,1628,2179,0.747,1190,2170,3360,1871,634,357,1319,2193,8463,0.427316,0
67,1982,Indiana Pacers,82,19830,3332,7164,0.465,103,316,0.326,3229,6848,0.472,1612,2176,0.741,1141,2372,3513,1897,753,494,1393,2041,8379,0.422542,0
68,1982,Atlanta Hawks*,82,19880,3210,6776,0.474,28,128,0.219,3182,6648,0.479,1833,2387,0.768,1135,2368,3503,1815,608,485,1343,2268,8281,0.416549,1
69,1983,Denver Nuggets*,82,19730,3951,7999,0.494,24,126,0.19,3927,7873,0.499,2179,2696,0.808,1214,2524,3738,2336,789,352,1496,2091,10105,0.512164,1
70,1983,Los Angeles Lakers*,82,19730,3964,7512,0.528,10,96,0.104,3954,7416,0.533,1495,2031,0.736,1235,2433,3668,2519,844,479,1584,1931,9433,0.478104,1
71,1983,San Antonio Spurs*,82,19780,3697,7340,0.504,94,308,0.305,3603,7032,0.512,1887,2468,0.765,1232,2599,3831,2261,675,469,1504,2095,9375,0.473964,1
72,1983,Kansas City Kings,82,19780,3719,7485,0.497,51,215,0.237,3668,7270,0.505,1839,2530,0.727,1256,2407,3663,2155,765,409,1691,2432,9328,0.471587,0
73,1983,Dallas Mavericks,82,19730,3674,7550,0.487,43,185,0.232,3631,7365,0.493,1852,2462,0.752,1296,2381,3677,2227,552,348,1348,2067,9243,0.468474,0
74,1983,Detroit Pistons,82,19880,3623,7602,0.477,72,272,0.265,3551,7330,0.484,1921,2588,0.742,1312,2477,3789,2108,679,572,1557,2122,9239,0.464738,0
75,1983,Boston Celtics*,82,19830,3711,7547,0.492,39,186,0.21,3672,7361,0.499,1730,2348,0.737,1273,2532,3805,2216,789,521,1541,2062,9191,0.463490,1
76,1983,Philadelphia 76ers*,82,19830,3600,7212,0.499,25,109,0.229,3575,7103,0.503,1966,2650,0.742,1334,2596,3930,2016,812,577,1627,2041,9191,0.463490,1
77,1983,Chicago Bulls,82,19905,3537,7373,0.48,45,209,0.215,3492,7164,0.487,1983,2690,0.737,1267,2527,3794,2086,666,400,1743,2192,9102,0.457272,0
78,1983,Seattle SuperSonics*,82,19805,3597,7277,0.494,29,138,0.21,3568,7139,0.5,1796,2459,0.73,1152,2569,3721,2278,677,437,1533,1969,9019,0.455390,1
79,1983,Utah Jazz,82,19755,3525,7342,0.48,44,183,0.24,3481,7159,0.486,1844,2440,0.756,1093,2550,3643,2176,758,595,1683,2017,8938,0.452442,0
80,1983,Indiana Pacers,82,19830,3707,7723,0.48,50,236,0.212,3657,7487,0.488,1447,1910,0.758,1299,2294,3593,2150,755,411,1535,2086,8911,0.449370,0
81,1983,Golden State Warriors,82,19780,3627,7508,0.483,34,150,0.227,3593,7358,0.488,1620,2199,0.737,1281,2284,3565,1964,856,430,1606,2138,8908,0.450354,0
82,1983,San Diego Clippers,82,19830,3625,7634,0.475,64,262,0.244,3561,7372,0.483,1589,2195,0.724,1394,2108,3502,2087,820,408,1600,2284,8903,0.448966,0
83,1983,Portland Trail Blazers*,82,19755,3459,7124,0.486,35,150,0.233,3424,6974,0.491,1855,2512,0.738,1180,2380,3560,2030,749,384,1495,1960,8808,0.445862,1
84,1983,Phoenix Suns*,82,19730,3555,7158,0.497,40,158,0.253,3515,7000,0.502,1626,2189,0.743,1094,2518,3612,2300,749,495,1545,2062,8776,0.444805,1
85,1983,Milwaukee Bucks*,82,19830,3486,7133,0.489,37,169,0.219,3449,6964,0.495,1731,2299,0.753,1095,2477,3572,2116,662,532,1447,2131,8740,0.440746,1
86,1983,New Jersey Nets*,82,19705,3510,7140,0.492,30,149,0.201,3480,6991,0.498,1622,2301,0.705,1266,2427,3693,2143,911,592,1873,2166,8672,0.440091,1
87,1983,Atlanta Hawks*,82,19780,3352,7146,0.469,45,188,0.239,3307,6958,0.475,1586,2111,0.751,1139,2433,3572,1945,573,665,1424,2022,8335,0.421385,1
88,1983,New York Knicks*,82,19805,3272,6793,0.482,33,131,0.252,3239,6662,0.486,1621,2282,0.71,1080,2263,3343,2034,701,378,1509,2180,8198,0.413936,1
89,1983,Houston Rockets,82,19730,3338,7446,0.448,67,271,0.247,3271,7175,0.456,1402,1934,0.725,1206,2260,3466,1931,646,422,1571,2131,8145,0.412823,0
90,1983,Washington Bullets,82,19805,3306,7059,0.468,70,237,0.295,3236,6822,0.474,1452,2059,0.705,1099,2430,3529,2046,733,400,1588,1958,8134,0.410704,0
91,1983,Cleveland Cavaliers,82,19755,3252,6995,0.465,30,120,0.25,3222,6875,0.469,1430,1983,0.721,1173,2414,3587,1738,617,290,1538,2236,7964,0.403138,0
92,1984,Denver Nuggets*,82,19805,3935,7983,0.493,77,255,0.302,3858,7728,0.499,2200,2690,0.818,1133,2444,3577,2482,711,352,1344,2279,10147,0.512345,1
93,1984,San Antonio Spurs,82,19980,3909,7721,0.506,79,263,0.3,3830,7458,0.514,1965,2604,0.755,1230,2528,3758,2361,685,491,1447,2146,9862,0.493594,0
94,1984,Detroit Pistons*,82,19905,3798,7910,0.48,32,141,0.227,3766,7769,0.485,1974,2547,0.775,1427,2434,3861,2256,697,417,1310,2177,9602,0.482391,1
95,1984,Los Angeles Lakers*,82,19780,3854,7250,0.532,58,226,0.257,3796,7024,0.54,1712,2272,0.754,1095,2499,3594,2455,726,478,1578,2054,9478,0.479171,1
96,1984,Utah Jazz*,82,19780,3606,7242,0.498,101,317,0.319,3505,6925,0.506,2115,2708,0.781,1096,2522,3618,2230,695,604,1510,1978,9428,0.476643,1
97,1984,Portland Trail Blazers*,82,19805,3632,7189,0.505,25,129,0.194,3607,7060,0.511,1988,2637,0.754,1251,2194,3445,2082,814,397,1483,2134,9277,0.468417,1
98,1984,Boston Celtics*,82,19955,3616,7235,0.5,55,229,0.24,3561,7006,0.508,1907,2407,0.792,1159,2538,3697,2122,673,430,1420,1949,9194,0.460737,1
99,1984,Phoenix Suns*,82,19780,3677,7220,0.509,74,291,0.254,3603,6929,0.52,1673,2204,0.759,1066,2298,3364,2214,693,388,1451,2147,9101,0.460111,1
100,1984,San Diego Clippers,82,19730,3634,7325,0.496,24,128,0.188,3610,7197,0.502,1785,2424,0.736,1307,2382,3689,1981,567,385,1515,2020,9077,0.460061,0
101,1984,Houston Rockets,82,19755,3729,7533,0.495,30,154,0.195,3699,7379,0.501,1583,2139,0.74,1200,2483,3683,2204,621,515,1562,2317,9071,0.459175,0
102,1984,Dallas Mavericks*,82,19955,3618,7235,0.5,42,184,0.228,3576,7051,0.507,1774,2350,0.755,1090,2265,3355,2164,579,360,1303,1906,9052,0.453621,1
103,1984,Kansas City Kings*,82,19755,3516,7230,0.486,52,189,0.275,3464,7041,0.492,1939,2495,0.777,1144,2273,3417,2229,715,383,1504,2200,9023,0.456745,1
104,1984,New Jersey Nets*,82,19805,3614,7258,0.498,49,232,0.211,3565,7026,0.507,1742,2488,0.7,1221,2313,3534,2148,814,499,1608,2243,9019,0.455390,1
105,1984,Golden State Warriors,82,19830,3519,7534,0.467,55,226,0.243,3464,7308,0.474,1915,2577,0.743,1390,2171,3561,1837,830,348,1518,2108,9008,0.454261,0
106,1984,Seattle SuperSonics*,82,19780,3460,7083,0.488,27,140,0.193,3433,6943,0.494,1918,2460,0.78,1064,2332,3396,2233,636,350,1360,1884,8865,0.448180,1
107,1984,Philadelphia 76ers*,82,19955,3384,6833,0.495,29,107,0.271,3355,6726,0.499,2041,2706,0.754,1181,2382,3563,2032,807,653,1628,2040,8838,0.442897,1
108,1984,New York Knicks*,82,19855,3386,6837,0.495,47,165,0.285,3339,6672,0.5,1944,2510,0.775,1088,2230,3318,2041,803,360,1587,2281,8763,0.441350,1
109,1984,Milwaukee Bucks*,82,19905,3432,6970,0.492,59,232,0.254,3373,6738,0.501,1743,2354,0.74,1135,2385,3520,2113,642,489,1415,2167,8666,0.435368,1
110,1984,Indiana Pacers,82,19780,3447,7130,0.483,48,207,0.232,3399,6923,0.491,1624,2119,0.766,1002,2398,3400,2169,834,398,1525,2061,8566,0.433064,0
111,1984,Chicago Bulls,82,19980,3305,6972,0.474,20,117,0.171,3285,6855,0.479,1871,2508,0.746,1141,2300,3441,2095,687,454,1578,2196,8501,0.425475,0
112,1984,Washington Bullets*,82,19905,3344,6907,0.484,71,282,0.252,3273,6625,0.494,1664,2201,0.756,1027,2387,3414,2192,556,320,1448,1989,8423,0.423160,1
113,1984,Cleveland Cavaliers,82,19855,3362,7232,0.465,43,164,0.262,3319,7068,0.47,1619,2178,0.743,1213,2388,3601,1930,630,375,1332,2206,8386,0.422362,0
114,1984,Atlanta Hawks*,82,19855,3230,6809,0.474,23,106,0.217,3207,6703,0.478,1838,2414,0.761,1112,2232,3344,1827,626,558,1329,2091,8321,0.419088,1
115,1985,Denver Nuggets*,82,19830,3876,7976,0.486,73,235,0.311,3803,7741,0.491,2016,2568,0.785,1331,2303,3634,2266,894,424,1382,2152,9841,0.496268,1
116,1985,Los Angeles Lakers*,82,19755,3952,7254,0.545,90,295,0.305,3862,6959,0.555,1702,2232,0.763,1063,2550,3613,2575,695,481,1537,1931,9696,0.490812,1
117,1985,Detroit Pistons*,82,19830,3840,7999,0.48,45,199,0.226,3795,7800,0.487,1783,2262,0.788,1403,2534,3937,2302,691,397,1341,2076,9508,0.479476,1
118,1985,Portland Trail Blazers*,82,19880,3708,7374,0.503,51,202,0.252,3657,7172,0.51,2002,2667,0.751,1202,2298,3500,2225,821,516,1481,1957,9469,0.476308,1
119,1985,Kansas City Kings,82,19755,3664,7275,0.504,63,238,0.265,3601,7037,0.512,2022,2595,0.779,1167,2327,3494,2342,661,300,1593,2169,9413,0.476487,0
120,1985,Boston Celtics*,82,19705,3721,7325,0.508,110,309,0.356,3611,7016,0.515,1860,2307,0.806,1116,2630,3746,2287,645,414,1332,1781,9412,0.477645,1
121,1985,San Antonio Spurs*,82,19780,3698,7202,0.513,55,202,0.272,3643,7000,0.52,1961,2571,0.763,1127,2470,3597,2316,757,443,1542,2180,9412,0.475834,1
122,1985,Philadelphia 76ers*,82,19805,3443,6992,0.492,59,224,0.263,3384,6768,0.5,2316,2883,0.803,1301,2364,3665,1999,817,534,1575,1971,9261,0.467609,1
123,1985,Houston Rockets*,82,19830,3748,7440,0.504,41,186,0.22,3707,7254,0.511,1581,2261,0.699,1325,2395,3720,2239,683,597,1605,2033,9118,0.459808,1
124,1985,Dallas Mavericks*,82,19855,3560,7280,0.489,152,443,0.343,3408,6837,0.498,1844,2324,0.793,1095,2345,3440,2152,575,335,1184,1796,9116,0.459129,1
125,1985,Milwaukee Bucks*,82,19805,3564,7256,0.491,89,294,0.303,3475,6962,0.499,1873,2473,0.757,1256,2353,3609,2164,689,486,1382,2239,9090,0.458975,1
126,1985,Golden State Warriors,82,19855,3498,7555,0.463,112,397,0.282,3386,7158,0.473,1944,2531,0.768,1327,2139,3466,1759,803,284,1460,2136,9052,0.455905,0
127,1985,New Jersey Nets*,82,19755,3646,7445,0.49,52,224,0.232,3594,7221,0.498,1631,2237,0.729,1233,2325,3558,2163,772,415,1355,2011,8975,0.454315,1
128,1985,Utah Jazz*,82,19755,3478,7302,0.476,103,307,0.336,3375,6995,0.482,1878,2434,0.772,1081,2554,3635,2143,712,697,1575,1961,8937,0.452392,1
129,1985,Chicago Bulls*,82,19805,3453,6909,0.5,29,161,0.18,3424,6748,0.507,1981,2526,0.784,1074,2366,3440,1992,622,468,1463,2071,8916,0.450189,1
130,1985,Cleveland Cavaliers*,82,19780,3470,7364,0.471,96,335,0.287,3374,7029,0.48,1867,2491,0.749,1203,2445,3648,2096,622,472,1387,2173,8903,0.450101,1
131,1985,Indiana Pacers,82,19780,3489,7324,0.476,30,155,0.194,3459,7169,0.482,1871,2516,0.744,1198,2623,3821,1945,625,366,1622,2237,8879,0.448888,0
132,1985,Phoenix Suns*,82,19805,3507,7144,0.491,87,307,0.283,3420,6837,0.5,1757,2280,0.771,1026,2425,3451,2335,727,349,1583,2034,8858,0.447261,1
133,1985,Los Angeles Clippers,82,19730,3527,7119,0.495,56,188,0.298,3471,6931,0.501,1674,2208,0.758,1163,2434,3597,1934,534,497,1587,1840,8784,0.445210,0
134,1985,Atlanta Hawks,82,19855,3444,7119,0.484,73,235,0.311,3371,6884,0.49,1782,2371,0.752,1161,2345,3506,2009,665,541,1475,2047,8743,0.440342,0
135,1985,Washington Bullets*,82,19855,3534,7383,0.479,109,398,0.274,3425,6985,0.49,1478,1989,0.743,1012,2395,3407,2088,709,393,1282,1869,8655,0.435910,1
136,1985,New York Knicks,82,19830,3435,7101,0.484,51,198,0.258,3384,6903,0.49,1706,2350,0.726,1116,2102,3218,1999,754,267,1458,2398,8627,0.435048,0
137,1985,Seattle SuperSonics,82,19705,3277,6910,0.474,45,185,0.243,3232,6725,0.481,1777,2305,0.771,1019,2287,3306,2185,649,343,1493,1974,8376,0.425070,0
138,1986,Los Angeles Lakers*,82,19830,3834,7343,0.522,138,409,0.337,3696,6934,0.533,1812,2329,0.778,1101,2555,3656,2433,693,419,1467,2031,9618,0.485023,1
139,1986,Dallas Mavericks*,82,19805,3631,7254,0.501,141,446,0.316,3490,6808,0.513,2050,2643,0.776,1059,2454,3513,2108,605,369,1289,1733,9453,0.477304,1
140,1986,Portland Trail Blazers*,82,19855,3610,7281,0.496,74,275,0.269,3536,7006,0.505,2142,2799,0.765,1153,2316,3469,2180,859,356,1529,2205,9436,0.475246,1
141,1986,Denver Nuggets*,82,19755,3705,7868,0.471,71,305,0.233,3634,7563,0.48,1929,2416,0.798,1223,2317,3540,2140,826,421,1336,2164,9410,0.476335,1
142,1986,Milwaukee Bucks*,82,19805,3601,7310,0.493,125,382,0.327,3476,6928,0.502,2063,2701,0.764,1189,2420,3609,2158,805,460,1369,2210,9390,0.474123,1
143,1986,Houston Rockets*,82,19755,3759,7671,0.49,85,310,0.274,3674,7361,0.499,1776,2434,0.73,1316,2434,3750,2318,745,551,1374,1991,9379,0.474766,1
144,1986,Detroit Pistons*,82,19780,3754,7750,0.484,55,182,0.302,3699,7568,0.489,1800,2300,0.783,1276,2461,3737,2319,738,340,1343,2101,9363,0.473357,1
145,1986,Boston Celtics*,82,19855,3718,7312,0.508,138,393,0.351,3580,6919,0.517,1785,2248,0.794,1054,2753,3807,2387,641,511,1360,1756,9359,0.471367,1
146,1986,Golden State Warriors,82,19780,3650,7567,0.482,87,278,0.313,3563,7289,0.489,1912,2517,0.76,1271,2344,3615,2018,751,354,1400,2032,9299,0.470121,0
147,1986,San Antonio Spurs*,82,19805,3596,7104,0.506,46,196,0.235,3550,6908,0.514,1882,2523,0.746,1069,2413,3482,2260,800,390,1624,2115,9120,0.460490,1
148,1986,Philadelphia 76ers*,82,19905,3435,7058,0.487,51,224,0.228,3384,6834,0.495,2130,2810,0.758,1326,2378,3704,2017,862,490,1595,1798,9051,0.454710,1
149,1986,Phoenix Suns,82,19805,3518,6993,0.503,38,183,0.208,3480,6810,0.511,1949,2683,0.726,1034,2449,3483,2272,773,379,1763,2260,9023,0.455592,0
150,1986,Chicago Bulls*,82,19855,3476,7227,0.481,88,317,0.278,3388,6910,0.49,1922,2499,0.769,1280,2278,3558,2006,609,400,1436,2166,8962,0.451372,1
151,1986,New Jersey Nets*,82,19805,3548,7301,0.486,43,214,0.201,3505,7087,0.495,1810,2396,0.755,1183,2483,3666,2128,749,345,1575,2129,8949,0.451856,1
152,1986,Sacramento Kings*,82,19780,3538,7220,0.49,30,134,0.224,3508,7086,0.495,1818,2338,0.778,1135,2377,3512,2304,602,388,1533,2134,8924,0.451163,1
153,1986,Los Angeles Clippers,82,19755,3388,7165,0.473,64,229,0.279,3324,6936,0.479,2067,2683,0.77,1159,2258,3417,1968,694,501,1506,1931,8907,0.450873,0
154,1986,Atlanta Hawks*,82,19805,3447,7029,0.49,33,166,0.199,3414,6863,0.497,1979,2704,0.732,1249,2405,3654,2025,736,434,1483,2170,8906,0.449684,1
155,1986,Utah Jazz*,82,19780,3453,7083,0.488,35,169,0.207,3418,6914,0.494,1930,2694,0.716,1068,2479,3547,2199,717,666,1518,2038,8871,0.448483,1
156,1986,Cleveland Cavaliers,82,19780,3478,7239,0.48,132,391,0.338,3346,6848,0.489,1748,2325,0.752,1086,2455,3541,2064,627,436,1411,2267,8836,0.446714,0
157,1986,Seattle SuperSonics,82,19930,3335,7059,0.472,79,300,0.263,3256,6759,0.482,1815,2331,0.779,1145,2256,3401,1977,745,295,1435,2168,8564,0.429704,0
158,1986,Indiana Pacers,82,19755,3441,7150,0.481,23,143,0.161,3418,7007,0.488,1614,2183,0.739,1138,2613,3751,2159,659,381,1515,2135,8519,0.431233,0
159,1986,Washington Bullets*,82,19855,3311,7148,0.463,116,408,0.284,3195,6740,0.474,1704,2286,0.745,1066,2432,3498,1748,626,716,1346,1796,8442,0.425183,1
160,1986,New York Knicks,82,19805,3239,7034,0.46,82,239,0.343,3157,6795,0.465,1534,2237,0.686,1081,2170,3251,1877,714,308,1438,2213,8094,0.408685,0
161,1987,Portland Trail Blazers*,82,19805,3650,7249,0.504,98,339,0.289,3552,6910,0.514,2269,2928,0.775,1180,2413,3593,2359,767,387,1546,2082,9667,0.488109,1
162,1987,Los Angeles Lakers*,82,19730,3740,7245,0.516,164,447,0.367,3576,6798,0.526,2012,2550,0.789,1127,2515,3642,2428,728,482,1358,1853,9656,0.489407,1
163,1987,Denver Nuggets*,82,19780,3744,7951,0.471,106,391,0.271,3638,7560,0.481,1975,2568,0.769,1294,2368,3662,2317,754,421,1216,2184,9569,0.483771,1
164,1987,Dallas Mavericks*,82,19880,3594,7373,0.487,231,653,0.354,3363,6720,0.5,2148,2717,0.791,1219,2494,3713,2017,688,424,1205,1873,9567,0.481237,1
165,1987,Seattle SuperSonics*,82,19855,3593,7451,0.482,191,571,0.335,3402,6880,0.494,1948,2571,0.758,1373,2395,3768,2184,705,450,1509,2224,9325,0.469655,1
166,1987,Boston Celtics*,82,19805,3645,7051,0.517,207,565,0.366,3438,6486,0.53,1740,2153,0.808,933,2585,3518,2421,561,526,1300,1710,9237,0.466397,1
167,1987,Golden State Warriors*,82,19905,3551,7412,0.479,116,364,0.319,3435,7048,0.487,1970,2526,0.78,1193,2351,3544,2083,715,321,1354,2138,9188,0.461593,1
168,1987,Detroit Pistons*,82,19830,3544,7237,0.49,39,169,0.231,3505,7068,0.496,1991,2602,0.765,1245,2649,3894,2021,643,436,1417,2078,9118,0.459808,1
169,1987,Phoenix Suns,82,19855,3575,7190,0.497,61,252,0.242,3514,6938,0.506,1900,2499,0.76,1113,2366,3479,2354,703,397,1498,2047,9111,0.458877,0
170,1987,Sacramento Kings,82,19780,3522,7413,0.475,77,307,0.251,3445,7106,0.485,1974,2479,0.796,1282,2441,3723,2185,513,397,1403,2007,9095,0.459808,0
171,1987,Milwaukee Bucks*,82,19780,3457,7282,0.475,185,572,0.323,3272,6710,0.488,1953,2549,0.766,1119,2322,3441,2044,845,393,1260,2180,9052,0.457634,1
172,1987,Atlanta Hawks*,82,19730,3435,7141,0.481,135,425,0.318,3300,6716,0.491,2019,2661,0.759,1350,2478,3828,2077,700,511,1279,2152,9024,0.457375,1
173,1987,New Jersey Nets,82,19855,3374,7083,0.476,145,449,0.323,3229,6634,0.487,2000,2607,0.767,1169,2409,3578,1991,643,397,1617,2353,8893,0.447897,0
174,1987,San Antonio Spurs,82,19805,3532,7456,0.474,117,403,0.29,3415,7053,0.484,1701,2292,0.742,1285,2347,3632,2220,786,325,1406,1930,8882,0.448473,0
175,1987,Utah Jazz*,82,19755,3485,7514,0.464,139,448,0.31,3346,7066,0.474,1735,2389,0.726,1194,2456,3650,2240,835,628,1403,2040,8844,0.447684,1
176,1987,Houston Rockets*,82,19780,3465,7262,0.477,89,324,0.275,3376,6938,0.487,1746,2355,0.741,1190,2481,3671,2227,654,555,1384,1973,8765,0.443124,1
177,1987,Philadelphia 76ers*,82,19880,3335,6792,0.491,88,340,0.259,3247,6452,0.503,1971,2617,0.753,1178,2327,3505,1943,768,540,1519,1774,8729,0.439085,1
178,1987,Indiana Pacers*,82,19930,3454,7324,0.472,94,316,0.297,3360,7008,0.479,1696,2170,0.782,1132,2464,3596,2170,697,311,1276,2097,8698,0.436427,1
179,1987,Washington Bullets*,82,19705,3356,7397,0.454,43,218,0.197,3313,7179,0.461,1935,2531,0.765,1305,2315,3620,1750,755,685,1301,1775,8690,0.441005,1
180,1987,Chicago Bulls*,82,19830,3382,7155,0.473,78,299,0.261,3304,6856,0.482,1754,2254,0.778,1248,2400,3648,2143,677,438,1257,1922,8596,0.433485,1
181,1987,Los Angeles Clippers,82,19780,3311,7332,0.452,78,348,0.224,3233,6984,0.463,1866,2515,0.742,1231,2137,3368,1971,751,432,1493,2004,8566,0.433064,0
182,1987,Cleveland Cavaliers,82,19755,3349,7122,0.47,81,338,0.24,3268,6784,0.482,1779,2554,0.697,1257,2420,3677,1912,672,559,1619,1853,8558,0.433207,0
183,1987,New York Knicks,82,19780,3329,7023,0.474,125,375,0.333,3204,6648,0.482,1725,2362,0.73,1108,2162,3270,1941,704,396,1420,2028,8508,0.430131,0
184,1988,Denver Nuggets*,82,19780,3770,7961,0.474,192,562,0.342,3578,7399,0.484,1841,2289,0.804,1163,2442,3605,2300,832,401,1186,1982,9573,0.483974,1
185,1988,Portland Trail Blazers*,82,19730,3661,7460,0.491,117,380,0.308,3544,7080,0.501,2079,2701,0.77,1251,2491,3742,2307,726,347,1351,2091,9518,0.482413,1
186,1988,Boston Celtics*,82,19780,3599,6905,0.521,271,705,0.384,3328,6200,0.537,1846,2300,0.803,930,2440,3370,2448,620,415,1304,1804,9315,0.470930,1
187,1988,San Antonio Spurs*,82,19805,3706,7559,0.49,133,412,0.323,3573,7147,0.5,1769,2412,0.733,1184,2335,3519,2344,739,468,1418,1991,9314,0.470285,1
188,1988,Los Angeles Lakers*,82,19805,3576,7078,0.505,142,478,0.297,3434,6600,0.52,1956,2480,0.789,1073,2491,3564,2347,672,404,1318,1715,9250,0.467054,1
189,1988,Seattle SuperSonics*,82,19855,3544,7443,0.476,221,638,0.346,3323,6805,0.488,1826,2442,0.748,1313,2314,3627,2146,775,447,1376,2380,9135,0.460086,1
190,1988,Dallas Mavericks*,82,19755,3413,7191,0.475,154,526,0.293,3259,6665,0.489,1980,2510,0.789,1341,2495,3836,1984,645,446,1257,1734,8960,0.453556,1
191,1988,Detroit Pistons*,82,19780,3461,7018,0.493,58,202,0.287,3403,6816,0.499,1977,2612,0.757,1181,2482,3663,2011,588,394,1348,1957,8957,0.452831,1
192,1988,Houston Rockets*,82,19680,3465,7354,0.471,69,291,0.237,3396,7063,0.481,1936,2483,0.78,1239,2530,3769,1936,712,502,1367,1865,8935,0.454014,1
193,1988,Phoenix Suns,82,19730,3551,7302,0.486,118,357,0.331,3433,6945,0.494,1681,2200,0.764,1113,2379,3492,2332,675,353,1413,2045,8901,0.451140,0
194,1988,Utah Jazz*,82,19705,3484,7092,0.491,129,404,0.319,3355,6688,0.502,1802,2404,0.75,1066,2553,3619,2407,771,627,1481,1986,8899,0.451611,1
195,1988,Sacramento Kings,82,19780,3458,7337,0.471,144,450,0.32,3314,6887,0.481,1795,2324,0.772,1232,2461,3693,2116,582,493,1457,1895,8855,0.447674,0
196,1988,Atlanta Hawks*,82,19780,3443,7102,0.485,85,282,0.301,3358,6820,0.492,1873,2441,0.767,1228,2379,3607,2062,635,537,1225,2050,8844,0.447118,1
197,1988,Golden State Warriors,82,19780,3463,7404,0.468,91,312,0.292,3372,7092,0.475,1754,2204,0.796,1140,2252,3392,2005,741,283,1395,2155,8771,0.443428,0
198,1988,Milwaukee Bucks*,82,19780,3366,7079,0.475,133,410,0.324,3233,6669,0.485,1832,2364,0.775,1117,2335,3452,2194,671,380,1275,1989,8697,0.439687,1
199,1988,Philadelphia 76ers,82,19905,3214,6785,0.474,152,471,0.323,3062,6314,0.485,2087,2731,0.764,1219,2307,3526,1897,672,465,1433,1866,8667,0.435418,0
200,1988,New York Knicks*,82,19805,3363,7232,0.465,179,567,0.316,3184,6665,0.478,1750,2306,0.759,1286,2194,3480,2012,789,445,1518,2361,8655,0.437011,1
201,1988,Washington Bullets*,82,19880,3355,7164,0.468,29,138,0.21,3326,7026,0.473,1914,2476,0.773,1229,2297,3526,1875,698,502,1384,1922,8653,0.435262,1
202,1988,Chicago Bulls*,82,19855,3434,7015,0.49,56,243,0.23,3378,6772,0.499,1685,2221,0.759,1170,2459,3629,2149,712,475,1263,1849,8609,0.433594,1
203,1988,Indiana Pacers,82,19705,3436,7154,0.48,163,485,0.336,3273,6669,0.491,1546,1982,0.78,1078,2457,3535,1977,619,345,1318,2038,8581,0.435473,0
204,1988,Cleveland Cavaliers*,82,19780,3313,6755,0.49,127,336,0.378,3186,6419,0.496,1813,2438,0.744,1015,2289,3304,2070,733,526,1439,1836,8566,0.433064,1
205,1988,New Jersey Nets,82,19780,3208,6857,0.468,137,455,0.301,3071,6402,0.48,1682,2308,0.729,1075,2262,3337,1795,727,385,1503,2042,8235,0.416330,0
206,1988,Los Angeles Clippers,82,19805,3190,7194,0.443,79,317,0.249,3111,6877,0.452,1644,2305,0.713,1191,2350,3541,1885,721,520,1534,1908,8103,0.409139,0
207,1989,Phoenix Suns*,82,19755,3754,7545,0.498,168,481,0.349,3586,7064,0.508,2051,2594,0.791,1095,2619,3714,2280,693,416,1279,1933,9727,0.492382,1
208,1989,Denver Nuggets*,82,19880,3813,8140,0.468,228,676,0.337,3585,7464,0.48,1821,2314,0.787,1206,2513,3719,2282,811,436,1225,2088,9675,0.486670,1
209,1989,New York Knicks*,82,19805,3701,7611,0.486,386,1147,0.337,3315,6464,0.513,1779,2366,0.752,1322,2265,3587,2083,900,446,1572,2053,9567,0.483060,1
210,1989,Golden State Warriors*,82,19905,3730,7977,0.468,194,629,0.308,3536,7348,0.481,1904,2384,0.799,1323,2561,3884,2009,831,643,1488,1946,9558,0.480181,1
211,1989,Los Angeles Lakers*,82,19805,3584,7143,0.502,227,667,0.34,3357,6476,0.518,2011,2508,0.802,1094,2612,3706,2282,724,421,1344,1672,9406,0.474931,1
212,1989,Portland Trail Blazers*,82,19830,3695,7795,0.474,216,645,0.335,3479,7150,0.487,1789,2416,0.74,1384,2381,3765,2212,828,388,1435,2026,9395,0.473777,1
213,1989,Seattle SuperSonics*,82,19780,3564,7478,0.477,293,774,0.379,3271,6704,0.488,1775,2379,0.746,1397,2238,3635,2083,864,494,1403,2027,9196,0.464914,1
214,1989,Philadelphia 76ers*,82,19780,3500,7201,0.486,204,646,0.316,3296,6555,0.503,1970,2504,0.787,1143,2356,3499,2110,689,354,1214,1721,9174,0.463802,1
215,1989,Atlanta Hawks*,82,19805,3412,7230,0.472,110,397,0.277,3302,6833,0.483,2168,2709,0.8,1372,2316,3688,1990,817,474,1310,1880,9102,0.459581,1
216,1989,Boston Celtics*,82,19780,3520,7143,0.493,78,309,0.252,3442,6834,0.504,1840,2349,0.783,1179,2442,3621,2189,639,418,1336,1876,8958,0.452882,1
217,1989,Milwaukee Bucks*,82,19755,3399,7167,0.474,179,567,0.316,3220,6600,0.488,1955,2382,0.821,1133,2272,3405,2071,821,323,1305,1953,8932,0.452139,1
218,1989,Cleveland Cavaliers*,82,19755,3466,6904,0.502,170,474,0.359,3296,6430,0.513,1821,2438,0.747,1033,2475,3508,2260,791,586,1323,1592,8923,0.451683,1
219,1989,Houston Rockets*,82,19855,3412,7196,0.474,164,523,0.314,3248,6673,0.487,1909,2527,0.755,1211,2554,3765,2016,789,501,1569,2026,8897,0.448099,1
220,1989,Washington Bullets,82,19855,3519,7591,0.464,52,243,0.214,3467,7348,0.472,1789,2318,0.772,1254,2354,3608,2048,694,325,1291,2054,8879,0.447192,0
221,1989,Indiana Pacers,82,19855,3385,6945,0.487,202,615,0.328,3183,6330,0.503,1795,2275,0.789,1065,2497,3562,2012,563,418,1547,2105,8767,0.441551,0
222,1989,Detroit Pistons*,82,19830,3395,6879,0.494,120,400,0.3,3275,6479,0.505,1830,2379,0.769,1154,2546,3700,2027,522,406,1336,1939,8740,0.440746,1
223,1989,Chicago Bulls*,82,19780,3448,6968,0.495,174,530,0.328,3274,6438,0.509,1656,2106,0.786,1018,2453,3471,2213,722,376,1327,1855,8726,0.441153,1
224,1989,Los Angeles Clippers,82,19855,3526,7428,0.475,54,234,0.231,3472,7194,0.483,1606,2220,0.723,1156,2384,3540,2208,815,530,1666,1937,8712,0.438781,0
225,1989,San Antonio Spurs,82,19755,3469,7409,0.468,63,293,0.215,3406,7116,0.479,1651,2367,0.698,1295,2181,3476,2037,961,423,1712,2153,8652,0.437965,0
226,1989,Sacramento Kings,82,19780,3362,7351,0.457,307,824,0.373,3055,6527,0.468,1620,2104,0.77,1141,2454,3595,1970,624,409,1370,1877,8651,0.437361,0
227,1989,Utah Jazz*,82,19730,3182,6595,0.482,114,380,0.3,3068,6215,0.494,2110,2742,0.77,1050,2607,3657,2108,720,583,1532,1894,8588,0.435276,1
228,1989,Charlotte Hornets,82,19780,3426,7430,0.461,134,430,0.312,3292,7000,0.47,1580,2060,0.767,1138,2200,3338,2323,705,264,1318,2068,8566,0.433064,0
229,1989,New Jersey Nets,82,19805,3333,7226,0.461,187,568,0.329,3146,6658,0.473,1653,2260,0.731,1204,2419,3623,1793,773,431,1449,1966,8506,0.429488,0
230,1989,Dallas Mavericks,82,19780,3244,6917,0.469,211,681,0.31,3033,6236,0.486,1785,2263,0.789,1048,2397,3445,1867,579,476,1233,1739,8484,0.428918,0
231,1989,Miami Heat,82,19855,3221,7116,0.453,97,298,0.326,3124,6818,0.458,1477,2103,0.702,1309,2211,3520,1958,744,408,1728,2124,8016,0.403727,0
232,1990,Golden State Warriors,82,19705,3489,7208,0.484,243,750,0.324,3246,6458,0.503,2313,2858,0.809,915,2385,3300,1978,756,488,1415,2010,9534,0.483837,0
233,1990,Phoenix Suns*,82,19855,3544,7139,0.496,176,543,0.324,3368,6596,0.511,2159,2716,0.795,1053,2651,3704,2109,668,501,1275,1825,9423,0.474591,1
234,1990,Denver Nuggets*,82,19805,3716,8015,0.464,228,677,0.337,3488,7338,0.475,1737,2201,0.789,1169,2532,3701,2275,814,329,1136,2047,9397,0.474476,1
235,1990,Portland Trail Blazers*,82,19880,3572,7547,0.473,190,565,0.336,3382,6982,0.484,2031,2734,0.743,1355,2552,3907,2085,749,364,1356,2048,9365,0.471076,1
236,1990,Orlando Magic,82,19805,3457,7525,0.459,116,393,0.295,3341,7132,0.468,2060,2725,0.756,1304,2465,3769,1993,617,294,1407,1975,9090,0.458975,0
237,1990,Los Angeles Lakers*,82,19855,3434,7010,0.49,309,841,0.367,3125,6169,0.507,1902,2417,0.787,1097,2460,3557,2232,655,445,1226,1737,9079,0.457265,1
238,1990,Philadelphia 76ers*,82,19805,3437,7028,0.489,189,543,0.348,3248,6485,0.501,1976,2509,0.788,1111,2406,3517,1932,687,365,1209,1697,9039,0.456400,1
239,1990,Boston Celtics*,82,19705,3563,7148,0.498,106,404,0.262,3457,6744,0.513,1791,2153,0.832,1066,2707,3773,2423,539,455,1256,1717,9023,0.457904,1
240,1990,Chicago Bulls*,82,19830,3531,7090,0.498,250,669,0.374,3281,6421,0.511,1665,2140,0.778,1075,2279,3354,2172,814,388,1247,1906,8977,0.452698,1
241,1990,Indiana Pacers*,82,19880,3381,6807,0.497,294,770,0.382,3087,6037,0.511,1906,2335,0.816,940,2388,3328,2023,552,350,1342,1972,8962,0.450805,1
242,1990,Atlanta Hawks,82,19730,3417,7019,0.487,124,411,0.302,3293,6608,0.498,1943,2544,0.764,1273,2187,3460,1820,717,353,1270,1871,8901,0.451140,0
243,1990,New York Knicks*,82,19830,3434,7089,0.484,236,710,0.332,3198,6379,0.501,1775,2349,0.756,1187,2426,3613,2140,714,492,1412,1828,8879,0.447756,1
244,1990,Washington Bullets,82,19830,3598,7581,0.475,37,197,0.188,3561,7384,0.482,1599,2093,0.764,1198,2450,3648,2214,561,424,1201,1929,8832,0.445386,0
245,1990,Seattle SuperSonics,82,19905,3466,7243,0.479,231,650,0.355,3235,6593,0.491,1606,2167,0.741,1323,2255,3578,1874,701,335,1336,2064,8769,0.440543,0
246,1990,Utah Jazz*,82,19830,3330,6593,0.505,226,630,0.359,3104,5963,0.521,1874,2484,0.754,953,2501,3454,2212,677,491,1410,2031,8760,0.441755,1
247,1990,Houston Rockets*,82,19805,3483,7250,0.48,153,491,0.312,3330,6759,0.493,1633,2267,0.72,1217,2638,3855,2194,809,551,1513,1934,8752,0.441909,1
248,1990,San Antonio Spurs*,82,19730,3388,6997,0.484,54,226,0.239,3334,6771,0.492,1888,2535,0.745,1163,2474,3637,2037,799,554,1399,1854,8718,0.441865,1
249,1990,Milwaukee Bucks*,82,19830,3380,7146,0.473,209,670,0.312,3171,6476,0.49,1722,2273,0.758,1108,2246,3354,2046,826,326,1315,2086,8691,0.438275,1
250,1990,Detroit Pistons*,82,19805,3333,6980,0.478,177,541,0.327,3156,6439,0.49,1713,2252,0.761,1185,2458,3643,1996,512,418,1233,1961,8556,0.432012,1
251,1990,Los Angeles Clippers,82,19805,3319,6853,0.484,56,230,0.243,3263,6623,0.493,1815,2458,0.738,1056,2362,3418,1978,782,507,1547,1859,8509,0.429639,0
252,1990,Cleveland Cavaliers*,82,19880,3214,6977,0.461,346,851,0.407,2868,6126,0.468,1637,2201,0.744,1128,2380,3508,2106,645,512,1243,1666,8411,0.423089,1
253,1990,Dallas Mavericks*,82,19855,3246,6831,0.475,157,486,0.323,3089,6345,0.487,1735,2261,0.767,1042,2419,3461,1776,664,398,1228,1733,8384,0.422261,1
254,1990,Sacramento Kings,82,19755,3305,7056,0.468,216,649,0.333,3089,6407,0.482,1515,1964,0.771,952,2363,3315,2052,546,392,1239,1863,8341,0.422222,0
255,1990,Miami Heat,82,19730,3383,7345,0.461,88,300,0.293,3295,7045,0.468,1393,2028,0.687,1242,2313,3555,1957,736,388,1557,2123,8247,0.417993,0
256,1990,Charlotte Hornets,82,19755,3270,7183,0.455,205,611,0.336,3065,6572,0.466,1487,1967,0.756,962,2211,3173,2080,778,262,1226,1889,8232,0.416705,0
257,1990,New Jersey Nets,82,19705,3157,7415,0.426,140,506,0.277,3017,6909,0.437,1754,2350,0.746,1363,2324,3687,1475,774,481,1360,1952,8208,0.416544,0
258,1990,Minnesota Timberwolves,82,19855,3067,6876,0.446,73,294,0.248,2994,6582,0.455,1596,2137,0.747,1196,2053,3249,1844,789,344,1197,1901,7803,0.392999,0
259,1991,Denver Nuggets,82,19730,3901,8868,0.44,300,1059,0.283,3601,7809,0.461,1726,2263,0.763,1520,2530,4050,2005,856,406,1332,2235,9828,0.498125,0
260,1991,Golden State Warriors*,82,19805,3566,7346,0.485,270,801,0.337,3296,6545,0.504,2162,2761,0.783,1113,2306,3419,1954,803,378,1359,2207,9564,0.482908,1
261,1991,Portland Trail Blazers*,82,19905,3577,7369,0.485,341,904,0.377,3236,6465,0.501,1912,2538,0.753,1202,2561,3763,2254,724,410,1309,1975,9407,0.472595,1
262,1991,Phoenix Suns*,82,19730,3573,7199,0.496,138,432,0.319,3435,6767,0.508,2064,2680,0.77,1132,2598,3730,2209,687,535,1302,1850,9348,0.473796,1
263,1991,Indiana Pacers*,82,19805,3450,6994,0.493,249,749,0.332,3201,6245,0.513,2010,2479,0.811,1018,2376,3394,2181,658,357,1355,2088,9159,0.462459,1
264,1991,Boston Celtics*,82,19805,3695,7214,0.512,109,346,0.315,3586,6868,0.522,1646,1997,0.824,1088,2697,3785,2160,672,565,1320,1695,9145,0.461752,1
265,1991,Chicago Bulls*,82,19755,3632,7125,0.51,155,424,0.366,3477,6701,0.519,1605,2111,0.76,1148,2342,3490,2212,822,438,1184,1751,9024,0.456796,1
266,1991,Atlanta Hawks*,82,19755,3349,7223,0.464,271,836,0.324,3078,6387,0.482,2034,2544,0.8,1235,2420,3655,1864,729,374,1231,1768,9003,0.455733,1
267,1991,San Antonio Spurs*,82,19830,3409,6988,0.488,81,297,0.273,3328,6691,0.497,1883,2459,0.766,1131,2657,3788,2140,670,571,1445,1896,8782,0.442864,1
268,1991,Houston Rockets*,82,19855,3403,7287,0.467,316,989,0.32,3087,6298,0.49,1631,2200,0.741,1275,2508,3783,1906,796,409,1402,1874,8753,0.440846,1
269,1991,Seattle SuperSonics*,82,19880,3500,7117,0.492,136,427,0.319,3364,6690,0.503,1608,2143,0.75,1222,2173,3395,2042,861,380,1404,1973,8744,0.439839,1
270,1991,Milwaukee Bucks*,82,19855,3337,6948,0.48,257,753,0.341,3080,6195,0.497,1796,2241,0.801,1079,2162,3241,2075,894,330,1321,2033,8727,0.439537,1
271,1991,Los Angeles Lakers*,82,19830,3343,6911,0.484,226,744,0.304,3117,6167,0.505,1805,2261,0.798,1078,2440,3518,2091,642,384,1203,1524,8717,0.439586,1
272,1991,Orlando Magic,82,19780,3298,7256,0.455,270,754,0.358,3028,6502,0.466,1818,2447,0.743,1233,2429,3662,1809,602,306,1391,1976,8684,0.439029,0
273,1991,Philadelphia 76ers*,82,20080,3289,6925,0.475,195,618,0.316,3094,6307,0.491,1868,2366,0.79,984,2496,3480,1824,678,479,1230,1629,8641,0.430329,1
274,1991,Utah Jazz*,82,19780,3214,6537,0.492,148,458,0.323,3066,6079,0.504,1951,2472,0.789,867,2474,3341,2217,652,451,1305,1796,8527,0.431092,1
275,1991,Los Angeles Clippers,82,19805,3391,7315,0.464,113,434,0.26,3278,6881,0.476,1596,2273,0.702,1246,2500,3746,2119,725,507,1438,2043,8491,0.428730,0
276,1991,New York Knicks*,82,19955,3308,6822,0.485,185,558,0.332,3123,6264,0.499,1654,2147,0.77,1053,2436,3489,2172,638,418,1379,1764,8455,0.423703,1
277,1991,New Jersey Nets,82,19830,3311,7459,0.444,161,586,0.275,3150,6873,0.458,1658,2245,0.739,1400,2348,3748,1782,748,600,1423,1954,8441,0.425668,0
278,1991,Charlotte Hornets,82,19805,3286,7033,0.467,131,417,0.314,3155,6616,0.477,1725,2214,0.779,1027,2200,3227,2019,759,304,1290,1946,8428,0.425549,0
279,1991,Miami Heat,82,19780,3280,7139,0.459,140,464,0.302,3140,6675,0.47,1649,2307,0.715,1232,2302,3534,1904,756,387,1551,2080,8349,0.422093,0
280,1991,Cleveland Cavaliers,82,19830,3259,6857,0.475,160,479,0.334,3099,6378,0.486,1665,2176,0.765,1011,2329,3340,2240,643,450,1281,1672,8343,0.420726,0
281,1991,Washington Bullets,82,19855,3390,7268,0.466,55,284,0.194,3335,6984,0.478,1478,2028,0.729,1173,2390,3563,2081,588,468,1359,1927,8313,0.418685,0
282,1991,Detroit Pistons*,82,19805,3194,6875,0.465,131,440,0.298,3063,6435,0.476,1686,2211,0.763,1206,2452,3658,1825,487,367,1181,1869,8205,0.414289,1
283,1991,Dallas Mavericks,82,19805,3245,6890,0.471,193,600,0.322,3052,6290,0.485,1512,1986,0.761,984,2360,3344,1821,581,397,1186,1840,8195,0.413784,0
284,1991,Minnesota Timberwolves,82,19905,3265,7276,0.449,108,381,0.283,3157,6895,0.458,1531,2082,0.735,1275,2113,3388,1885,712,440,1062,1864,8169,0.410399,0
285,1991,Sacramento Kings,82,19705,3086,6818,0.453,216,578,0.374,2870,6240,0.46,1540,2105,0.732,1027,2218,3245,1991,631,513,1272,2075,7928,0.402334,0
286,1992,Golden State Warriors*,82,19880,3767,7427,0.507,254,763,0.333,3513,6664,0.527,1944,2606,0.746,1137,2376,3513,2064,854,375,1353,2049,9732,0.489537,1
287,1992,Indiana Pacers*,82,19955,3498,7079,0.494,333,940,0.354,3165,6139,0.516,1868,2364,0.79,1083,2564,3647,2398,705,393,1402,2137,9197,0.460887,1
288,1992,Phoenix Suns*,82,19805,3553,7219,0.492,227,596,0.381,3326,6623,0.502,1861,2397,0.776,1088,2558,3646,2202,673,582,1242,1852,9194,0.464226,1
289,1992,Portland Trail Blazers*,82,19880,3476,7352,0.473,325,944,0.344,3151,6408,0.492,1858,2463,0.754,1294,2549,3843,2065,753,410,1328,1983,9135,0.459507,1
290,1992,Chicago Bulls*,82,19830,3643,7168,0.508,138,454,0.304,3505,6714,0.522,1587,2132,0.744,1173,2439,3612,2279,672,480,1088,1693,9011,0.454413,1
291,1992,Charlotte Hornets,82,19805,3613,7568,0.477,117,369,0.317,3496,7199,0.486,1637,2168,0.755,1164,2367,3531,2284,822,309,1273,1819,8980,0.453421,0
292,1992,Cleveland Cavaliers*,82,19805,3427,7025,0.488,253,708,0.357,3174,6317,0.502,1819,2259,0.805,1041,2450,3491,2260,616,621,1073,1556,8926,0.450694,1
293,1992,Utah Jazz*,82,19880,3379,6866,0.492,158,458,0.345,3221,6408,0.503,1961,2490,0.788,1097,2543,3640,2188,715,448,1264,1746,8877,0.446529,1
294,1992,Boston Celtics*,82,19780,3543,7196,0.492,110,359,0.306,3433,6837,0.502,1549,1917,0.808,1095,2583,3678,2072,636,484,1165,1686,8745,0.442113,1
295,1992,Seattle SuperSonics*,82,19855,3380,7128,0.474,205,647,0.317,3175,6481,0.49,1772,2263,0.783,1282,2257,3539,1877,775,448,1323,1952,8737,0.440040,1
296,1992,Atlanta Hawks,82,19905,3492,7476,0.467,210,671,0.313,3282,6805,0.482,1517,2074,0.731,1288,2498,3786,2123,793,320,1255,1771,8711,0.437629,0
297,1992,New Jersey Nets*,82,19780,3473,7580,0.458,224,670,0.334,3249,6910,0.47,1471,2009,0.732,1512,2392,3904,1937,736,615,1392,1834,8641,0.436855,1
298,1992,Milwaukee Bucks,82,19880,3321,7216,0.46,371,1005,0.369,2950,6211,0.475,1596,2104,0.759,1297,2172,3469,2018,863,317,1350,1904,8609,0.433048,0
299,1992,Miami Heat*,82,19830,3256,7061,0.461,257,751,0.342,2999,6310,0.475,1839,2329,0.79,1187,2366,3553,1749,670,373,1377,1819,8608,0.434090,1
300,1992,Sacramento Kings,82,19830,3348,7189,0.466,238,675,0.353,3110,6514,0.477,1615,2162,0.747,1054,2354,3408,1957,727,618,1360,1763,8549,0.431114,0
301,1992,San Antonio Spurs*,82,19780,3377,7090,0.476,118,404,0.292,3259,6686,0.487,1652,2246,0.736,1229,2552,3781,2010,729,608,1308,1799,8524,0.430940,1
302,1992,Los Angeles Clippers*,82,19830,3347,7076,0.473,145,502,0.289,3202,6574,0.487,1601,2223,0.72,1132,2393,3525,2053,824,498,1269,1873,8440,0.425618,1
303,1992,Washington Bullets,82,19855,3364,7301,0.461,146,537,0.272,3218,6764,0.476,1521,1956,0.778,1069,2345,3414,2011,713,422,1254,1852,8395,0.422815,0
304,1992,Houston Rockets,82,19880,3273,6894,0.475,329,959,0.343,2944,5935,0.496,1491,2020,0.738,1074,2432,3506,2058,656,571,1378,1769,8366,0.420825,0
305,1992,Philadelphia 76ers,82,19755,3187,6761,0.471,227,680,0.334,2960,6081,0.487,1757,2267,0.775,1058,2309,3367,1755,692,482,1238,1582,8358,0.423083,0
306,1992,Orlando Magic,82,19705,3220,7102,0.453,197,608,0.324,3023,6494,0.466,1693,2268,0.746,1171,2329,3500,1792,643,367,1389,1977,8330,0.422735,0
307,1992,New York Knicks*,82,19855,3312,6947,0.477,201,618,0.325,3111,6329,0.492,1503,2049,0.734,1185,2489,3674,2130,634,382,1242,1905,8328,0.419441,1
308,1992,Minnesota Timberwolves,82,19805,3366,7342,0.458,126,394,0.32,3240,6948,0.466,1379,1857,0.743,1167,2168,3335,2025,619,526,1157,1866,8237,0.415905,0
309,1992,Los Angeles Lakers*,82,19830,3183,6977,0.456,119,445,0.267,3064,6532,0.469,1744,2278,0.766,1156,2196,3352,1803,756,400,1089,1543,8229,0.414977,1
310,1992,Denver Nuggets,82,19780,3262,7380,0.442,126,418,0.301,3136,6962,0.45,1526,2067,0.738,1350,2352,3702,1553,773,461,1447,1984,8176,0.413347,0
311,1992,Detroit Pistons*,82,19780,3191,6867,0.465,165,526,0.314,3026,6341,0.477,1566,2108,0.743,1210,2421,3631,1899,546,357,1212,1646,8113,0.410162,1
312,1992,Dallas Mavericks,82,19755,3120,7104,0.439,268,797,0.336,2852,6307,0.452,1499,1999,0.75,1194,2439,3633,1630,536,349,1202,1867,8007,0.405315,0
313,1993,Phoenix Suns*,82,19730,3494,7093,0.493,398,1095,0.363,3096,5998,0.516,1912,2539,0.753,1141,2510,3651,2087,752,455,1359,1739,9298,0.471262,1
314,1993,Charlotte Hornets*,82,19755,3512,7210,0.487,175,537,0.326,3337,6673,0.5,1831,2374,0.771,1095,2508,3603,2161,639,473,1325,1790,9030,0.457099,1
315,1993,Golden State Warriors,82,19905,3474,7212,0.482,298,852,0.35,3176,6360,0.499,1768,2465,0.717,1219,2384,3603,2010,693,383,1451,2056,9014,0.452851,0
316,1993,Portland Trail Blazers*,82,19905,3361,7343,0.458,275,843,0.326,3086,6500,0.475,1901,2551,0.745,1226,2507,3733,1969,770,425,1215,1892,8898,0.447023,1
317,1993,Seattle SuperSonics*,82,19780,3473,7140,0.486,218,610,0.357,3255,6530,0.498,1720,2259,0.761,1222,2254,3476,1906,944,409,1267,1971,8884,0.449141,1
318,1993,Sacramento Kings,82,19780,3360,7264,0.463,262,788,0.332,3098,6476,0.478,1865,2447,0.762,1137,2281,3418,2075,768,348,1364,2085,8847,0.447270,0
319,1993,Indiana Pacers*,82,19755,3371,7022,0.48,257,789,0.326,3114,6233,0.5,1837,2399,0.766,1220,2455,3675,2144,615,403,1256,2045,8836,0.447279,1
320,1993,Cleveland Cavaliers*,82,19830,3425,6887,0.497,283,742,0.381,3142,6145,0.511,1699,2119,0.802,929,2496,3425,2349,615,536,1120,1580,8832,0.445386,1
321,1993,Atlanta Hawks*,82,19830,3392,7272,0.466,382,1076,0.355,3010,6196,0.486,1648,2221,0.742,1290,2344,3634,2084,806,278,1339,1807,8814,0.444478,1
322,1993,Los Angeles Clippers*,82,19805,3544,7329,0.484,133,491,0.271,3411,6838,0.499,1562,2177,0.718,1183,2360,3543,2242,847,491,1338,1920,8783,0.443474,1
323,1993,Utah Jazz*,82,19755,3336,6828,0.489,130,414,0.314,3206,6414,0.5,1907,2491,0.766,1041,2463,3504,2177,746,344,1270,1965,8709,0.440850,1
324,1993,Orlando Magic,82,19880,3257,6708,0.486,317,889,0.357,2940,5819,0.505,1821,2495,0.73,1040,2566,3606,1952,542,467,1429,1925,8652,0.435211,0
325,1993,San Antonio Spurs*,82,19855,3311,6762,0.49,236,692,0.341,3075,6070,0.507,1794,2346,0.765,919,2542,3461,2012,582,514,1227,1844,8652,0.435759,1
326,1993,Denver Nuggets,82,19830,3352,7282,0.46,138,454,0.304,3214,6828,0.471,1784,2360,0.756,1266,2564,3830,1735,651,565,1413,2039,8626,0.434997,0
327,1993,Chicago Bulls*,82,19830,3475,7205,0.482,244,669,0.365,3231,6536,0.494,1431,1952,0.733,1290,2283,3573,2133,783,410,1103,1804,8625,0.434947,1
328,1993,Philadelphia 76ers,82,19930,3225,7075,0.456,330,941,0.351,2895,6134,0.472,1776,2259,0.786,1031,2431,3462,2038,672,566,1362,1604,8556,0.429303,0
329,1993,Los Angeles Lakers*,82,19830,3309,6994,0.473,187,626,0.299,3122,6368,0.49,1741,2304,0.756,1103,2288,3391,2013,782,431,1266,1778,8546,0.430963,1
330,1993,Houston Rockets*,82,19780,3280,6744,0.486,387,1073,0.361,2893,5671,0.51,1584,2090,0.758,985,2532,3517,2115,682,543,1295,1699,8531,0.431294,1
331,1993,Boston Celtics*,82,19780,3453,7093,0.487,110,383,0.287,3343,6710,0.498,1486,1912,0.777,1076,2436,3512,1999,647,458,1174,1862,8502,0.429828,1
332,1993,Miami Heat,82,20005,3127,6850,0.456,333,940,0.354,2794,5910,0.473,1908,2476,0.771,1134,2384,3518,1688,609,350,1287,2011,8495,0.424644,0
333,1993,New Jersey Nets*,82,19780,3272,7084,0.462,155,488,0.318,3117,6596,0.473,1732,2258,0.767,1291,2506,3797,1872,693,526,1355,1892,8431,0.426239,1
334,1993,Milwaukee Bucks,82,19730,3268,6924,0.472,312,936,0.333,2956,5988,0.494,1544,2081,0.742,1050,2113,3163,2084,863,393,1363,1978,8392,0.425342,0
335,1993,Washington Bullets,82,19805,3302,7065,0.467,174,578,0.301,3128,6487,0.482,1575,2107,0.748,1031,2317,3348,2110,673,359,1323,1795,8353,0.421762,0
336,1993,New York Knicks*,82,19930,3209,6898,0.465,193,604,0.32,3016,6294,0.479,1717,2316,0.741,1150,2660,3810,2125,680,372,1296,2111,8328,0.417863,1
337,1993,Detroit Pistons,82,19780,3267,7211,0.453,292,908,0.322,2975,6303,0.472,1426,1957,0.729,1293,2315,3608,1941,580,249,1152,1747,8252,0.417189,0
338,1993,Dallas Mavericks,82,19730,3164,7271,0.435,283,837,0.338,2881,6434,0.448,1530,2171,0.705,1234,2265,3499,1683,649,355,1459,2302,8141,0.412620,0
339,1993,Minnesota Timberwolves,82,19855,3043,6529,0.466,166,569,0.292,2877,5960,0.483,1794,2247,0.798,940,2204,3144,2001,649,455,1422,2028,8046,0.405238,0
340,1994,Phoenix Suns*,82,19705,3429,7080,0.484,344,1042,0.33,3085,6038,0.511,1674,2301,0.728,1220,2453,3673,2261,745,460,1305,1639,8876,0.450444,1
341,1994,Golden State Warriors*,82,19780,3512,7145,0.492,291,859,0.339,3221,6286,0.512,1529,2304,0.664,1183,2396,3579,2198,804,511,1433,1789,8844,0.447118,1
342,1994,Portland Trail Blazers*,82,19755,3371,7427,0.454,272,770,0.353,3099,6657,0.466,1781,2396,0.743,1302,2460,3762,2070,744,409,1210,1827,8795,0.445204,1
343,1994,Charlotte Hornets,82,19830,3382,7100,0.476,336,916,0.367,3046,6184,0.493,1632,2135,0.764,1019,2475,3494,2214,724,394,1266,1747,8732,0.440343,0
344,1994,Seattle SuperSonics*,82,19730,3338,6901,0.484,242,722,0.335,3096,6179,0.501,1769,2374,0.745,1148,2233,3381,2112,1053,365,1262,1914,8687,0.440294,1
345,1994,Orlando Magic*,82,19730,3341,6883,0.485,394,1137,0.347,2947,5746,0.513,1590,2346,0.678,1177,2356,3533,2070,683,456,1327,1713,8666,0.439230,1
346,1994,Miami Heat*,82,19805,3197,6896,0.464,337,997,0.338,2860,5899,0.485,1744,2223,0.785,1235,2407,3642,1856,643,374,1315,2024,8475,0.427922,1
347,1994,New Jersey Nets*,82,19830,3169,7115,0.445,223,683,0.327,2946,6432,0.458,1900,2495,0.762,1300,2556,3856,1900,696,576,1196,1693,8461,0.426677,1
348,1994,Los Angeles Clippers,82,19780,3343,7163,0.467,252,831,0.303,3091,6332,0.488,1509,2128,0.709,1120,2410,3530,2169,807,421,1474,1769,8447,0.427048,0
349,1994,Utah Jazz*,82,19830,3207,6729,0.477,179,559,0.32,3028,6170,0.491,1761,2379,0.74,1059,2385,3444,2179,751,364,1191,1988,8354,0.421281,1
350,1994,Atlanta Hawks*,82,19755,3247,7039,0.461,268,830,0.323,2979,6209,0.48,1556,2070,0.752,1250,2423,3673,2056,915,449,1252,1625,8318,0.421058,1
351,1994,Cleveland Cavaliers*,82,19855,3133,6731,0.465,294,813,0.362,2839,5918,0.48,1736,2254,0.77,1090,2353,3443,2049,705,426,1136,1701,8296,0.417829,1
352,1994,Houston Rockets*,82,19780,3197,6733,0.475,429,1285,0.334,2768,5448,0.508,1469,1978,0.743,926,2619,3545,2087,717,485,1338,1646,8292,0.419211,1
353,1994,Sacramento Kings,82,19755,3179,7027,0.452,257,729,0.353,2922,6298,0.464,1676,2292,0.731,1122,2349,3471,2029,669,355,1333,1979,8291,0.419691,0
354,1994,Indiana Pacers*,82,19755,3167,6516,0.486,184,500,0.368,2983,6016,0.496,1762,2387,0.738,1130,2409,3539,2055,706,457,1440,1974,8280,0.419134,1
355,1994,Boston Celtics,82,19905,3333,7057,0.472,138,477,0.289,3195,6580,0.486,1463,2003,0.73,1037,2380,3417,1928,674,440,1242,1849,8267,0.415323,0
356,1994,Los Angeles Lakers,82,19755,3291,7316,0.45,241,803,0.3,3050,6513,0.468,1410,1967,0.717,1260,2204,3464,1983,751,461,1197,1877,8233,0.416755,0
357,1994,Washington Bullets,82,19705,3195,6826,0.468,221,744,0.297,2974,6082,0.489,1618,2162,0.748,1071,2189,3260,1823,701,321,1403,1715,8229,0.417610,0
358,1994,Denver Nuggets*,82,19755,3156,6781,0.465,170,597,0.285,2986,6184,0.483,1739,2423,0.718,1105,2557,3662,1763,679,686,1422,1926,8221,0.416148,1
359,1994,San Antonio Spurs*,82,19780,3178,6688,0.475,249,714,0.349,2929,5974,0.49,1597,2151,0.742,1189,2597,3786,1896,561,450,1198,1662,8202,0.414661,1
360,1994,New York Knicks*,82,19755,3098,6735,0.46,316,908,0.348,2782,5827,0.477,1564,2097,0.746,1175,2542,3717,2067,752,385,1360,2001,8076,0.408808,1
361,1994,Philadelphia 76ers,82,19805,3103,6819,0.455,318,942,0.338,2785,5877,0.474,1509,2112,0.714,1012,2394,3406,1827,663,525,1368,1488,8033,0.405605,0
362,1994,Chicago Bulls*,82,19780,3245,6815,0.476,233,659,0.354,3012,6156,0.489,1310,1859,0.705,1143,2391,3534,2102,740,354,1306,1750,8033,0.406117,1
363,1994,Milwaukee Bucks,82,19705,3044,6807,0.447,331,1019,0.325,2713,5788,0.469,1530,2181,0.702,1126,2154,3280,1946,800,407,1343,1821,7949,0.403400,0
364,1994,Detroit Pistons,82,19730,3169,7017,0.452,358,1041,0.344,2811,5976,0.47,1253,1715,0.731,1027,2320,3347,1767,602,309,1236,1935,7949,0.402889,0
365,1994,Minnesota Timberwolves,82,19730,2985,6535,0.457,183,557,0.329,2802,5978,0.469,1777,2303,0.772,990,2343,3333,1967,600,440,1478,2016,7930,0.401926,0
366,1994,Dallas Mavericks,82,19730,3055,7070,0.432,241,773,0.312,2814,6297,0.447,1450,1942,0.747,1271,2150,3421,1629,767,299,1393,2007,7801,0.395388,0
367,1995,Orlando Magic*,82,19930,3460,6899,0.502,523,1412,0.37,2937,5487,0.535,1648,2465,0.669,1149,2457,3606,2281,672,488,1297,1726,9091,0.456147,1
368,1995,Phoenix Suns*,82,19830,3356,6967,0.482,584,1584,0.369,2772,5383,0.515,1777,2352,0.756,1027,2403,3430,2198,687,312,1167,1839,9073,0.457539,1
369,1995,Seattle SuperSonics*,82,19830,3310,6741,0.491,491,1305,0.376,2819,5436,0.519,1944,2564,0.758,1068,2337,3405,2115,917,392,1295,2067,9055,0.456631,1
370,1995,San Antonio Spurs*,82,19855,3236,6687,0.484,434,1158,0.375,2802,5529,0.507,1836,2487,0.738,1029,2661,3690,1919,656,456,1246,1871,8742,0.440292,1
371,1995,Utah Jazz*,82,19780,3243,6339,0.512,301,801,0.376,2942,5538,0.531,1939,2483,0.781,874,2412,3286,2256,758,392,1289,2045,8726,0.441153,1
372,1995,Golden State Warriors,82,19905,3217,6873,0.468,546,1602,0.341,2671,5271,0.507,1687,2395,0.704,1101,2371,3472,2017,649,391,1497,1804,8667,0.435418,0
373,1995,Los Angeles Lakers*,82,19905,3284,7088,0.463,525,1492,0.352,2759,5596,0.493,1523,2072,0.735,1126,2316,3442,2078,750,563,1243,1933,8616,0.432856,1
374,1995,Houston Rockets*,82,19730,3159,6579,0.48,646,1757,0.368,2513,4822,0.521,1527,2039,0.749,880,2440,3320,2060,721,514,1322,1714,8491,0.430360,1
375,1995,Dallas Mavericks,82,19930,3227,7342,0.44,386,1200,0.322,2841,6142,0.463,1622,2210,0.734,1514,2433,3947,1941,579,348,1345,1811,8462,0.424586,0
376,1995,Portland Trail Blazers*,82,19705,3217,7134,0.451,462,1266,0.365,2755,5868,0.469,1555,2230,0.697,1352,2443,3795,1846,668,467,1212,2024,8451,0.428876,1
377,1995,Boston Celtics*,82,19805,3179,6847,0.464,362,984,0.368,2817,5863,0.48,1708,2268,0.753,1156,2320,3476,1783,612,361,1305,1975,8428,0.425549,1
378,1995,Chicago Bulls*,82,19830,3191,6710,0.476,443,1187,0.373,2748,5523,0.498,1500,2065,0.726,1106,2294,3400,1970,797,352,1297,1962,8325,0.419818,1
379,1995,Denver Nuggets*,82,19980,3098,6461,0.479,413,1160,0.356,2685,5301,0.507,1700,2305,0.738,1040,2402,3442,1836,660,585,1381,2063,8309,0.415866,1
380,1995,Miami Heat,82,19805,3144,6738,0.467,436,1182,0.369,2708,5556,0.487,1569,2133,0.736,1092,2272,3364,1779,662,298,1291,2000,8293,0.418733,0
381,1995,Charlotte Hornets*,82,19805,3051,6438,0.474,560,1409,0.397,2491,5029,0.495,1587,2042,0.777,832,2395,3227,2072,620,399,1224,1685,8249,0.416511,1
382,1995,Washington Bullets,82,19855,3176,6899,0.46,433,1264,0.343,2743,5635,0.487,1457,2013,0.724,1044,2219,3263,1749,648,404,1301,1949,8242,0.415110,0
383,1995,Milwaukee Bucks,82,19855,3022,6586,0.459,494,1349,0.366,2528,5237,0.483,1608,2259,0.712,1063,2187,3250,1737,674,359,1393,1858,8146,0.410274,0
384,1995,Indiana Pacers*,82,19780,2983,6248,0.477,374,985,0.38,2609,5263,0.496,1796,2390,0.751,1051,2290,3341,1877,703,363,1340,1939,8136,0.411325,1
385,1995,Sacramento Kings,82,19855,3025,6463,0.468,359,1037,0.346,2666,5426,0.491,1647,2317,0.711,1073,2325,3398,1824,650,457,1449,2040,8056,0.405742,0
386,1995,New York Knicks*,82,19780,2985,6394,0.467,532,1446,0.368,2453,4948,0.496,1552,2114,0.734,929,2473,3402,2055,591,387,1305,2102,8054,0.407179,1
387,1995,Detroit Pistons,82,19730,3060,6633,0.461,494,1396,0.354,2566,5237,0.49,1439,1941,0.741,958,2204,3162,1872,705,420,1318,2151,8053,0.408160,0
388,1995,New Jersey Nets,82,19880,2939,6738,0.436,414,1297,0.319,2525,5441,0.464,1750,2305,0.759,1213,2569,3782,1884,544,548,1300,1844,8042,0.404527,0
389,1995,Los Angeles Clippers,82,19880,3060,6888,0.444,331,1051,0.315,2729,5837,0.468,1476,2079,0.71,1064,2076,3140,1805,787,435,1334,2152,7927,0.398742,0
390,1995,Atlanta Hawks*,82,19855,2986,6680,0.447,539,1580,0.341,2447,5100,0.48,1410,1948,0.724,1104,2272,3376,1757,738,412,1221,1804,7921,0.398942,1
391,1995,Philadelphia 76ers,82,19805,2949,6577,0.448,355,936,0.379,2594,5641,0.46,1567,2125,0.737,1105,2230,3335,1566,643,576,1355,1835,7820,0.394850,0
392,1995,Minnesota Timberwolves,82,19780,2792,6219,0.449,318,1016,0.313,2474,5203,0.475,1824,2355,0.775,883,2090,2973,1780,609,402,1400,2074,7726,0.390597,0
393,1995,Cleveland Cavaliers*,82,19930,2756,6255,0.441,398,1033,0.385,2358,5222,0.452,1507,1982,0.76,1045,2237,3282,1672,630,349,1176,1694,7417,0.372153,1
394,1996,Chicago Bulls*,82,19730,3293,6892,0.478,544,1349,0.403,2749,5543,0.496,1495,2004,0.746,1247,2411,3658,2033,745,345,1175,1807,8625,0.437152,1
395,1996,Seattle SuperSonics*,82,19880,3074,6401,0.48,581,1596,0.364,2493,4805,0.519,1843,2424,0.76,954,2449,3403,1999,882,393,1441,1967,8572,0.431187,1
396,1996,Orlando Magic*,82,19855,3203,6640,0.482,622,1645,0.378,2581,4995,0.517,1543,2232,0.691,966,2401,3367,2080,663,406,1160,1709,8571,0.431680,1
397,1996,Phoenix Suns*,82,19955,3159,6673,0.473,327,984,0.332,2832,5689,0.498,1907,2472,0.771,1009,2501,3510,2001,623,331,1207,1776,8552,0.428564,1
398,1996,Boston Celtics,82,19905,3163,6942,0.456,539,1453,0.371,2624,5489,0.478,1630,2284,0.714,1050,2427,3477,1792,653,406,1302,2041,8495,0.426777,0
399,1996,San Antonio Spurs*,82,19780,3148,6602,0.477,518,1320,0.392,2630,5282,0.498,1663,2261,0.736,937,2586,3523,2044,645,536,1195,1820,8477,0.428564,1
400,1996,Los Angeles Lakers*,82,19680,3216,6706,0.48,477,1359,0.351,2739,5347,0.512,1529,2049,0.746,995,2303,3298,2080,722,516,1163,1702,8438,0.428760,1
401,1996,Charlotte Hornets,82,19880,3108,6618,0.47,584,1520,0.384,2524,5098,0.495,1631,2119,0.77,987,2256,3243,1907,582,277,1241,1815,8431,0.424095,0
402,1996,Dallas Mavericks,82,19930,3124,7431,0.42,735,2039,0.36,2389,5392,0.443,1426,1975,0.722,1408,2379,3787,1913,642,342,1270,1836,8409,0.421927,0
403,1996,Washington Bullets,82,19805,3202,6618,0.484,493,1212,0.407,2709,5406,0.501,1511,2076,0.728,930,2327,3257,1815,592,506,1327,1981,8408,0.424539,0
404,1996,Houston Rockets*,82,19805,3078,6638,0.464,637,1761,0.362,2441,4877,0.501,1611,2106,0.765,919,2455,3374,1982,645,476,1245,1753,8404,0.424337,1
405,1996,Utah Jazz*,82,19780,3129,6417,0.488,377,1013,0.372,2752,5404,0.509,1769,2302,0.768,993,2373,3366,2139,667,418,1215,2046,8404,0.424874,1
406,1996,Golden State Warriors,82,19755,3056,6700,0.456,447,1199,0.373,2609,5501,0.474,1775,2340,0.759,1173,2285,3458,1889,706,470,1343,1835,8334,0.421868,0
407,1996,Sacramento Kings*,82,19755,2971,6494,0.457,462,1194,0.387,2509,5300,0.473,1759,2407,0.731,1114,2345,3459,1829,643,436,1442,2131,8163,0.413212,1
408,1996,Los Angeles Clippers,82,19730,3126,6618,0.472,509,1374,0.37,2617,5244,0.499,1392,1984,0.702,979,2190,3169,1672,703,411,1355,2008,8153,0.413229,0
409,1996,Portland Trail Blazers*,82,19905,3064,6688,0.458,480,1358,0.353,2584,5330,0.485,1537,2321,0.662,1160,2577,3737,1760,594,417,1377,1859,8145,0.409194,1
410,1996,Indiana Pacers*,82,19755,2979,6205,0.48,363,973,0.373,2616,5232,0.5,1823,2416,0.755,1010,2262,3272,1917,579,323,1335,2031,8144,0.412250,1
411,1996,Atlanta Hawks*,82,19730,2985,6665,0.448,566,1595,0.355,2419,5070,0.477,1523,2012,0.757,1182,2148,3330,1609,771,319,1228,1714,8059,0.408464,1
412,1996,Minnesota Timberwolves,82,19780,2974,6481,0.459,279,857,0.326,2695,5624,0.479,1797,2314,0.777,985,2271,3256,1867,650,481,1426,1994,8024,0.405662,0
413,1996,Denver Nuggets,82,19830,3001,6657,0.451,397,1148,0.346,2604,5509,0.473,1614,2173,0.743,1057,2487,3544,1851,521,597,1265,1882,8013,0.404085,0
414,1996,Toronto Raptors,82,19830,3084,6598,0.467,414,1168,0.354,2670,5430,0.492,1412,1953,0.723,1071,2213,3284,1927,745,493,1544,1987,7994,0.403127,0
415,1996,New York Knicks*,82,19830,3003,6382,0.471,485,1285,0.377,2518,5097,0.494,1480,1954,0.757,829,2449,3278,1822,645,377,1272,1864,7971,0.401967,1
416,1996,Miami Heat*,82,19780,2902,6348,0.457,552,1458,0.379,2350,4890,0.481,1553,2187,0.71,999,2495,3494,1752,574,439,1394,2158,7909,0.399848,1
417,1996,Milwaukee Bucks,82,19730,3034,6490,0.467,357,1056,0.338,2677,5434,0.493,1412,1914,0.738,973,2164,3137,1755,582,307,1295,1943,7837,0.397212,0
418,1996,Detroit Pistons*,82,19830,2810,6122,0.459,545,1350,0.404,2265,4772,0.475,1657,2206,0.751,884,2440,3324,1610,506,352,1215,1953,7822,0.394453,1
419,1996,Philadelphia 76ers,82,19730,2796,6418,0.436,492,1438,0.342,2304,4980,0.463,1662,2263,0.734,1031,2161,3192,1629,643,420,1414,1777,7746,0.392600,0
420,1996,New Jersey Nets,82,19905,2881,6750,0.427,250,746,0.335,2631,6004,0.438,1672,2244,0.745,1350,2503,3853,1752,627,571,1375,1880,7684,0.386034,0
421,1996,Cleveland Cavaliers*,82,19830,2761,5998,0.46,596,1582,0.377,2165,4416,0.49,1355,1775,0.763,867,2055,2922,1818,674,340,1073,1685,7473,0.376853,1
422,1996,Vancouver Grizzlies,82,19880,2772,6483,0.428,372,1129,0.329,2400,5354,0.448,1446,1998,0.724,957,2170,3127,1706,728,333,1347,1852,7362,0.370322,0
423,1997,Chicago Bulls*,82,19730,3277,6923,0.473,523,1403,0.373,2754,5520,0.499,1381,1848,0.747,1235,2461,3696,2142,716,332,1109,1617,8458,0.428687,1
424,1997,Utah Jazz*,82,19830,3131,6217,0.504,334,902,0.37,2797,5315,0.526,1858,2416,0.769,889,2410,3299,2199,748,418,1259,1981,8454,0.426324,1
425,1997,Phoenix Suns*,82,19855,3143,6705,0.469,527,1428,0.369,2616,5277,0.496,1618,2125,0.761,916,2376,3292,2067,664,322,1180,1727,8431,0.424629,1
426,1997,Seattle SuperSonics*,82,19780,2995,6415,0.467,559,1583,0.353,2436,4832,0.504,1725,2295,0.752,1010,2271,3281,1931,904,388,1231,1803,8274,0.418301,1
427,1997,Boston Celtics,82,19905,3066,6967,0.44,467,1331,0.351,2599,5636,0.461,1649,2199,0.75,1095,2188,3283,1792,810,315,1342,1915,8248,0.414368,0
428,1997,Houston Rockets*,82,19855,3037,6484,0.468,671,1839,0.365,2366,4645,0.509,1503,1992,0.755,927,2565,3492,2013,685,347,1365,1610,8248,0.415412,1
429,1997,Philadelphia 76ers,82,19780,3003,6850,0.438,433,1356,0.319,2570,5494,0.468,1776,2450,0.725,1267,2355,3622,1695,683,394,1437,1733,8215,0.415319,0
430,1997,Los Angeles Lakers*,82,19930,3018,6642,0.454,551,1500,0.367,2467,5142,0.48,1613,2330,0.692,1092,2414,3506,1845,740,575,1222,1818,8200,0.411440,1
431,1997,Golden State Warriors,82,19905,2997,6567,0.456,481,1363,0.353,2516,5204,0.483,1696,2180,0.778,1086,2259,3345,1822,611,359,1410,1787,8171,0.410500,0
432,1997,Washington Bullets*,82,19855,3208,6678,0.48,331,1001,0.331,2877,5677,0.507,1400,1979,0.707,1010,2420,3430,1921,712,402,1289,1815,8147,0.410325,1
433,1997,Portland Trail Blazers*,82,19855,3000,6465,0.464,501,1401,0.358,2499,5064,0.493,1613,2261,0.713,1058,2494,3552,1710,640,435,1357,1928,8114,0.408663,1
434,1997,Charlotte Hornets*,82,19805,2988,6342,0.471,591,1382,0.428,2397,4960,0.483,1541,1984,0.777,910,2298,3208,2021,597,349,1203,1702,8108,0.409392,1
435,1997,Denver Nuggets,82,19930,2934,6687,0.439,636,1711,0.372,2298,4976,0.462,1516,1992,0.761,994,2452,3446,1889,503,487,1359,1784,8020,0.402408,0
436,1997,New Jersey Nets,82,19780,2994,7091,0.422,484,1371,0.353,2510,5720,0.439,1502,2031,0.74,1410,2376,3786,1726,677,481,1290,1865,7974,0.403134,0
437,1997,Los Angeles Clippers*,82,19930,2989,6696,0.446,474,1339,0.354,2515,5357,0.469,1517,2074,0.731,1092,2242,3334,1662,733,441,1311,1964,7969,0.399849,1
438,1997,Sacramento Kings,82,19855,3000,6611,0.454,414,1058,0.391,2586,5553,0.466,1494,2067,0.723,1100,2307,3407,1799,588,362,1332,1946,7908,0.398288,0
439,1997,Minnesota Timberwolves*,82,19780,2937,6436,0.456,371,1093,0.339,2566,5343,0.48,1637,2180,0.751,957,2302,3259,1874,618,557,1243,1818,7882,0.398483,1
440,1997,Toronto Raptors,82,19830,2897,6632,0.437,589,1624,0.363,2308,5008,0.461,1446,2008,0.72,1135,2254,3389,1714,722,517,1347,1883,7829,0.394806,0
441,1997,New York Knicks*,82,19855,2882,6227,0.463,470,1294,0.363,2412,4933,0.489,1585,2119,0.748,973,2516,3489,1809,629,378,1462,2033,7819,0.393805,1
442,1997,Indiana Pacers,82,19930,2851,6254,0.456,430,1130,0.381,2421,5124,0.472,1687,2336,0.722,1029,2390,3419,1750,585,394,1338,1977,7819,0.392323,0
443,1997,Milwaukee Bucks,82,19730,2967,6303,0.471,324,920,0.352,2643,5383,0.491,1560,2104,0.741,955,2263,3218,1610,632,348,1285,1892,7818,0.396249,0
444,1997,Miami Heat*,82,19805,2822,6235,0.453,678,1865,0.364,2144,4370,0.491,1454,2022,0.719,957,2402,3359,1735,650,439,1306,1919,7776,0.392628,1
445,1997,Atlanta Hawks*,82,19805,2812,6307,0.446,659,1834,0.359,2153,4473,0.481,1491,1955,0.763,1021,2350,3371,1557,701,427,1228,1591,7774,0.392527,1
446,1997,Detroit Pistons*,82,19830,2827,6095,0.464,582,1499,0.388,2245,4596,0.488,1487,1995,0.745,858,2292,3150,1554,632,283,1041,1652,7723,0.389460,1
447,1997,Orlando Magic*,82,19855,2839,6497,0.437,567,1662,0.341,2272,4835,0.47,1474,1975,0.746,1071,2221,3292,1689,694,363,1250,1643,7719,0.388769,1
448,1997,Dallas Mavericks,82,19805,2813,6452,0.436,430,1316,0.327,2383,5136,0.464,1375,1918,0.717,1040,2262,3302,1663,654,351,1324,1798,7431,0.375208,0
449,1997,San Antonio Spurs,82,19730,2827,6391,0.442,378,1180,0.32,2449,5211,0.47,1386,1929,0.719,1101,2129,3230,1661,646,431,1243,1764,7418,0.375976,0
450,1997,Vancouver Grizzlies,82,19780,2819,6453,0.437,445,1274,0.349,2374,5179,0.458,1230,1734,0.709,1023,2155,3178,1862,657,464,1301,1755,7313,0.369717,0
451,1997,Cleveland Cavaliers,82,19855,2704,5972,0.453,483,1284,0.376,2221,4688,0.474,1282,1773,0.723,909,2159,3068,1714,655,315,1188,1882,7173,0.361269,0
452,1998,Los Angeles Lakers*,82,19830,3146,6536,0.481,497,1415,0.351,2649,5121,0.517,1863,2743,0.679,1079,2471,3550,2009,734,556,1256,1859,8652,0.436309,1
453,1998,Minnesota Timberwolves*,82,19930,3157,6844,0.461,303,873,0.347,2854,5971,0.478,1673,2253,0.743,1063,2429,3492,2068,639,427,1138,1882,8290,0.415956,1
454,1998,Utah Jazz*,82,19780,2993,6113,0.49,249,670,0.372,2744,5443,0.504,2044,2644,0.773,962,2405,3367,2070,648,412,1260,1961,8279,0.418554,1
455,1998,Seattle SuperSonics*,82,19755,3052,6458,0.473,621,1569,0.396,2431,4889,0.497,1521,2109,0.721,931,2225,3156,1986,804,376,1145,1812,8246,0.417413,1
456,1998,New Jersey Nets*,82,19880,3055,6928,0.441,310,937,0.331,2745,5991,0.458,1750,2351,0.744,1344,2137,3481,1685,777,314,1180,1917,8170,0.410966,1
457,1998,Phoenix Suns*,82,19955,3138,6710,0.468,431,1211,0.356,2707,5499,0.492,1459,1948,0.749,991,2452,3443,2124,756,429,1236,1765,8166,0.409221,1
458,1998,Houston Rockets*,82,19830,2946,6513,0.452,573,1670,0.343,2373,4843,0.49,1634,2120,0.771,987,2350,3337,1799,686,294,1298,1653,8099,0.408422,1
459,1998,Washington Wizards,82,19805,3080,6811,0.452,320,944,0.339,2760,5867,0.47,1489,2156,0.691,1121,2341,3462,1900,689,379,1156,1839,7969,0.402373,0
460,1998,Chicago Bulls*,82,19855,3064,6801,0.451,311,962,0.323,2753,5839,0.471,1492,2009,0.743,1243,2438,3681,1952,696,353,1178,1691,7931,0.399446,1
461,1998,Charlotte Hornets*,82,19780,2968,6344,0.468,346,904,0.383,2622,5440,0.482,1641,2186,0.751,985,2341,3326,1941,691,312,1247,1757,7923,0.400556,1
462,1998,Vancouver Grizzlies,82,19830,3006,6567,0.458,325,898,0.362,2681,5669,0.473,1586,2145,0.739,1081,2313,3394,1960,614,349,1405,1809,7923,0.399546,0
463,1998,Indiana Pacers*,82,19830,2921,6223,0.469,401,1029,0.39,2520,5194,0.485,1631,2136,0.764,874,2348,3222,1889,645,368,1168,1859,7874,0.397075,1
464,1998,Los Angeles Clippers,82,19780,2930,6690,0.438,525,1468,0.358,2405,5222,0.461,1480,2047,0.723,1040,2276,3316,1533,625,456,1323,1827,7865,0.397624,0
465,1998,Boston Celtics,82,19730,3012,6934,0.434,415,1249,0.332,2597,5685,0.457,1425,1964,0.726,1196,2044,3240,1816,987,366,1330,2203,7864,0.398581,0
466,1998,Atlanta Hawks*,82,19880,2887,6352,0.455,337,1016,0.332,2550,5336,0.478,1749,2314,0.756,1106,2417,3523,1569,653,491,1214,1671,7860,0.395372,1
467,1998,Miami Heat*,82,19755,2850,6327,0.45,548,1544,0.355,2302,4783,0.481,1539,2082,0.739,1028,2419,3447,1758,665,429,1226,1982,7787,0.394179,1
468,1998,Toronto Raptors,82,19930,2965,6813,0.435,372,1086,0.343,2593,5727,0.453,1479,2060,0.718,1187,2149,3336,1746,769,663,1371,1851,7781,0.390416,0
469,1998,Milwaukee Bucks,82,19930,2918,6399,0.456,249,703,0.354,2669,5696,0.469,1663,2167,0.767,1035,2236,3271,1649,733,357,1383,1915,7748,0.388761,0
470,1998,Portland Trail Blazers*,82,19830,2885,6397,0.451,324,1047,0.309,2561,5350,0.479,1640,2226,0.737,1086,2522,3608,1766,585,464,1383,1859,7734,0.390015,1
471,1998,Detroit Pistons,82,19955,2862,6373,0.449,293,938,0.312,2569,5435,0.473,1704,2288,0.745,1044,2338,3382,1597,678,344,1198,1805,7721,0.386921,0
472,1998,Philadelphia 76ers,82,19755,2837,6409,0.443,243,810,0.3,2594,5599,0.463,1734,2352,0.737,1125,2294,3419,1729,729,490,1354,1878,7651,0.387294,0
473,1998,Sacramento Kings,82,19730,2957,6684,0.442,283,806,0.351,2674,5878,0.455,1440,2096,0.687,1094,2304,3398,1836,596,420,1271,1810,7637,0.387076,0
474,1998,San Antonio Spurs*,82,19830,2898,6187,0.468,302,863,0.35,2596,5324,0.488,1489,2164,0.688,984,2638,3622,1839,516,568,1318,1731,7587,0.382602,1
475,1998,Cleveland Cavaliers*,82,19830,2817,6207,0.454,298,801,0.372,2519,5406,0.466,1653,2187,0.756,955,2331,3286,1894,814,419,1418,1939,7585,0.382501,1
476,1998,New York Knicks*,82,19830,2864,6413,0.447,382,1139,0.335,2482,5274,0.471,1399,1812,0.772,978,2434,3412,1787,634,278,1247,1947,7509,0.378669,1
477,1998,Dallas Mavericks,82,19905,2882,6754,0.427,422,1183,0.357,2460,5571,0.442,1308,1738,0.753,1008,2280,3288,1535,646,466,1182,1643,7494,0.376488,0
478,1998,Orlando Magic,82,19830,2771,6455,0.429,293,907,0.323,2478,5548,0.447,1552,2138,0.726,1178,2203,3381,1694,649,441,1258,1617,7387,0.372516,0
479,1998,Denver Nuggets,82,19730,2677,6412,0.417,288,893,0.323,2389,5519,0.433,1658,2147,0.772,1040,2157,3197,1547,664,393,1311,1937,7300,0.369995,0
480,1998,Golden State Warriors,82,19830,2845,6883,0.413,189,696,0.272,2656,6187,0.429,1358,1912,0.71,1288,2473,3761,1708,621,448,1369,1859,7237,0.364952,0
481,1999,Sacramento Kings*,50,12200,1918,4307,0.445,290,943,0.308,1628,3364,0.484,883,1293,0.683,706,1573,2279,1129,444,232,842,1016,5009,0.410574,1
482,1999,Los Angeles Lakers*,50,12050,1841,3935,0.468,241,685,0.352,1600,3250,0.492,1027,1503,0.683,619,1482,2101,1095,389,287,754,1231,4950,0.410788,1
483,1999,Phoenix Suns*,50,12050,1797,4004,0.449,261,702,0.372,1536,3302,0.465,924,1215,0.76,598,1418,2016,1249,444,200,681,1022,4779,0.396598,1
484,1999,Seattle SuperSonics,50,12100,1756,3976,0.442,309,899,0.344,1447,3077,0.47,922,1354,0.681,676,1422,2098,1087,393,201,765,1047,4743,0.391983,0
485,1999,Portland Trail Blazers*,50,12175,1747,3956,0.442,246,675,0.364,1501,3281,0.457,1002,1349,0.743,646,1570,2216,1073,411,290,771,1126,4742,0.389487,1
486,1999,Indiana Pacers*,50,12100,1731,3866,0.448,294,799,0.368,1437,3067,0.469,977,1228,0.796,574,1452,2026,1005,316,223,649,1082,4733,0.391157,1
487,1999,Houston Rockets*,50,12075,1755,3798,0.462,336,914,0.368,1419,2884,0.492,865,1187,0.729,536,1540,2076,1058,386,260,812,960,4711,0.390145,1
488,1999,Denver Nuggets,50,12025,1681,3989,0.421,302,922,0.328,1379,3067,0.45,1010,1325,0.762,647,1392,2039,969,376,275,739,1145,4674,0.388690,0
489,1999,Utah Jazz*,50,12175,1684,3620,0.465,140,388,0.361,1544,3232,0.478,1158,1510,0.767,555,1508,2063,1204,398,276,814,1133,4666,0.383244,1
490,1999,Boston Celtics,50,12150,1816,4164,0.436,273,758,0.36,1543,3406,0.453,745,1077,0.692,680,1458,2138,1073,453,255,807,1193,4650,0.382716,0
491,1999,Minnesota Timberwolves*,50,12025,1838,4327,0.425,122,410,0.298,1716,3917,0.438,849,1143,0.743,754,1392,2146,1218,426,272,641,1185,4647,0.386445,1
492,1999,Charlotte Hornets,50,12150,1671,3718,0.449,268,735,0.365,1403,2983,0.47,1034,1384,0.747,480,1493,1973,1110,443,247,796,1101,4644,0.382222,0
493,1999,San Antonio Spurs*,50,12075,1740,3812,0.456,172,521,0.33,1568,3291,0.476,988,1415,0.698,614,1584,2198,1101,421,351,759,1010,4640,0.384265,1
494,1999,Milwaukee Bucks*,50,12050,1753,3818,0.459,231,619,0.373,1522,3199,0.476,847,1155,0.733,570,1369,1939,1030,442,202,719,1142,4584,0.380415,1
495,1999,Dallas Mavericks,50,12075,1749,4033,0.434,202,595,0.339,1547,3438,0.45,881,1210,0.728,645,1478,2123,921,352,292,692,1065,4581,0.379379,0
496,1999,New Jersey Nets,50,12050,1691,4160,0.406,225,679,0.331,1466,3481,0.421,962,1251,0.769,715,1437,2152,923,491,273,750,1134,4569,0.379170,0
497,1999,Washington Wizards,50,12050,1768,3969,0.445,179,580,0.309,1589,3389,0.469,845,1198,0.705,595,1403,1998,1064,393,193,736,1151,4560,0.378423,0
498,1999,Toronto Raptors,50,12075,1660,3940,0.421,226,662,0.341,1434,3278,0.437,1011,1330,0.76,712,1447,2159,1036,439,321,799,1139,4557,0.377391,0
499,1999,Los Angeles Clippers,50,12125,1711,4007,0.427,214,668,0.32,1497,3339,0.448,883,1225,0.721,665,1293,1958,820,424,236,796,1223,4519,0.372701,0
500,1999,Detroit Pistons*,50,12050,1660,3716,0.447,248,679,0.365,1412,3037,0.465,950,1283,0.74,605,1412,2017,1009,444,208,790,1139,4518,0.374938,1
501,1999,Philadelphia 76ers*,50,12150,1656,3883,0.426,98,371,0.264,1558,3512,0.444,1073,1486,0.722,729,1428,2157,934,542,271,822,1152,4483,0.368971,1
502,1999,Orlando Magic*,50,12050,1687,3943,0.428,223,675,0.33,1464,3268,0.448,876,1252,0.7,688,1445,2133,1067,496,213,819,935,4473,0.371203,1
503,1999,Miami Heat*,50,12025,1616,3565,0.453,289,804,0.359,1327,2761,0.481,928,1262,0.735,503,1512,2015,1019,327,304,744,1035,4449,0.369979,1
504,1999,Vancouver Grizzlies,50,12175,1643,3838,0.428,148,453,0.327,1495,3385,0.442,1009,1408,0.717,650,1359,2009,964,420,199,848,1123,4443,0.364928,0
505,1999,Golden State Warriors,50,12125,1730,4173,0.415,162,565,0.287,1568,3608,0.435,794,1175,0.676,816,1559,2375,1037,414,221,768,1270,4416,0.364206,0
506,1999,Cleveland Cavaliers,50,12050,1562,3561,0.439,182,534,0.341,1380,3027,0.456,1016,1356,0.749,472,1316,1788,1093,452,203,785,1208,4322,0.358672,0
507,1999,New York Knicks*,50,12100,1610,3704,0.435,208,589,0.353,1402,3115,0.45,892,1218,0.732,551,1510,2061,963,395,262,804,1140,4320,0.357025,1
508,1999,Atlanta Hawks*,50,12075,1539,3760,0.409,197,644,0.306,1342,3116,0.431,1040,1422,0.731,676,1499,2175,782,346,260,745,987,4315,0.357350,1
509,1999,Chicago Bulls,50,12075,1539,3837,0.401,177,612,0.289,1362,3225,0.422,840,1185,0.709,573,1394,1967,1017,436,169,774,1112,4095,0.339130,0
510,2000,Sacramento Kings*,82,19805,3276,7288,0.45,534,1656,0.322,2742,5632,0.487,1521,2016,0.754,1056,2635,3691,1953,787,381,1325,1729,8607,0.434587,1
511,2000,Detroit Pistons*,82,19830,3044,6635,0.459,439,1223,0.359,2605,5412,0.481,1956,2506,0.781,917,2458,3375,1707,665,273,1288,2011,8483,0.427786,1
512,2000,Dallas Mavericks,82,19730,3195,7047,0.453,519,1326,0.391,2676,5721,0.468,1407,1751,0.804,931,2444,3375,1810,592,416,1124,1770,8316,0.421490,0
513,2000,Indiana Pacers*,82,19730,3047,6640,0.459,583,1487,0.392,2464,5153,0.478,1629,2008,0.811,842,2612,3454,1857,559,422,1159,1786,8306,0.420983,1
514,2000,Milwaukee Bucks*,82,19855,3174,6827,0.465,394,1069,0.369,2780,5758,0.483,1558,1982,0.786,1016,2373,3389,1852,671,381,1230,2020,8300,0.418031,1
515,2000,Los Angeles Lakers*,82,19805,3137,6836,0.459,344,1047,0.329,2793,5789,0.482,1649,2368,0.696,1117,2738,3855,1921,613,534,1143,1841,8267,0.417420,1
516,2000,Orlando Magic,82,19755,3169,7014,0.452,294,870,0.338,2875,6144,0.468,1574,2142,0.735,1145,2540,3685,1709,743,467,1443,1967,8206,0.415389,0
517,2000,Houston Rockets,82,19830,3001,6664,0.45,581,1625,0.358,2420,5039,0.48,1573,2145,0.733,1008,2586,3594,1774,613,438,1425,1663,8156,0.411296,0
518,2000,Boston Celtics,82,19730,3054,6880,0.444,417,1260,0.331,2637,5620,0.469,1621,2175,0.745,1108,2420,3528,1741,795,286,1259,2223,8146,0.412874,0
519,2000,Seattle SuperSonics*,82,19780,3108,6946,0.447,546,1611,0.339,2562,5335,0.48,1363,1960,0.695,1042,2483,3525,1878,657,345,1152,1776,8125,0.410768,1
520,2000,Denver Nuggets,82,19855,3057,6911,0.442,470,1397,0.336,2587,5514,0.469,1531,2116,0.724,1073,2590,3663,1911,554,618,1281,1962,8115,0.408713,0
521,2000,Phoenix Suns*,82,19805,3093,6771,0.457,458,1246,0.368,2635,5525,0.477,1467,1934,0.759,1022,2558,3580,2098,744,433,1368,1973,8111,0.409543,1
522,2000,Minnesota Timberwolves*,82,19905,3226,6910,0.467,248,716,0.346,2978,6194,0.481,1379,1769,0.78,1016,2471,3487,2205,622,444,1139,1913,8079,0.405878,1
523,2000,Charlotte Hornets*,82,19780,2935,6533,0.449,339,1001,0.339,2596,5532,0.469,1863,2458,0.758,884,2635,3519,2023,732,480,1206,1670,8072,0.408089,1
524,2000,New Jersey Nets,82,19830,2979,6881,0.433,477,1374,0.347,2502,5507,0.454,1601,2041,0.784,1040,2315,3355,1688,720,393,1119,1913,8036,0.405245,0
525,2000,Portland Trail Blazers*,82,19780,3021,6430,0.47,407,1128,0.361,2614,5302,0.493,1542,2029,0.76,966,2560,3526,1925,633,396,1243,1865,7991,0.403994,1
526,2000,Toronto Raptors*,82,19755,2980,6882,0.433,425,1171,0.363,2555,5711,0.447,1583,2068,0.765,1098,2449,3547,1947,666,544,1137,1989,7968,0.403341,1
527,2000,Cleveland Cavaliers,82,19855,2977,6734,0.442,343,919,0.373,2634,5815,0.453,1653,2205,0.75,1010,2499,3509,1941,715,363,1427,2219,7950,0.400403,0
528,2000,Washington Wizards,82,19805,3010,6681,0.451,335,890,0.376,2675,5791,0.462,1566,2107,0.743,1064,2438,3502,1771,593,383,1320,2149,7921,0.399950,0
529,2000,Utah Jazz*,82,19755,2962,6380,0.464,329,854,0.385,2633,5526,0.476,1661,2150,0.773,936,2426,3362,2041,629,446,1220,2013,7914,0.400607,1
530,2000,San Antonio Spurs*,82,19855,2952,6393,0.462,330,882,0.374,2622,5511,0.476,1652,2214,0.746,927,2666,3593,1819,614,551,1233,1716,7886,0.397180,1
531,2000,Golden State Warriors,82,19755,2996,7140,0.42,345,1069,0.323,2651,6071,0.437,1497,2147,0.697,1300,2438,3738,1851,731,356,1302,2043,7834,0.396558,0
532,2000,Philadelphia 76ers*,82,19830,2993,6776,0.442,208,643,0.323,2785,6133,0.454,1577,2226,0.708,1147,2468,3615,1817,791,386,1284,1939,7771,0.391881,1
533,2000,Miami Heat*,82,19830,2974,6462,0.46,446,1202,0.371,2528,5260,0.481,1345,1827,0.736,921,2619,3540,1931,582,524,1231,1947,7739,0.390267,1
534,2000,Atlanta Hawks,82,19830,3000,6807,0.441,258,814,0.317,2742,5993,0.458,1477,1987,0.743,1146,2570,3716,1548,500,461,1266,1718,7735,0.390066,0
535,2000,Vancouver Grizzlies,82,19855,2892,6441,0.449,324,898,0.361,2568,5543,0.463,1594,2060,0.774,1005,2324,3329,1700,608,346,1381,1881,7702,0.387912,0
536,2000,New York Knicks*,82,19830,2897,6374,0.455,351,937,0.375,2546,5437,0.468,1410,1805,0.781,802,2521,3323,1588,515,349,1201,1983,7555,0.380988,1
537,2000,Los Angeles Clippers,82,19705,2877,6757,0.426,429,1267,0.339,2448,5490,0.446,1363,1826,0.746,955,2377,3332,1479,578,494,1325,1821,7546,0.382948,0
538,2000,Chicago Bulls,82,19805,2565,6180,0.415,340,1032,0.329,2225,5148,0.432,1482,2089,0.709,1032,2323,3355,1645,646,383,1557,1908,6952,0.351022,0
539,2001,Sacramento Kings*,82,20080,3132,6969,0.449,479,1353,0.354,2653,5616,0.472,1600,2075,0.771,987,2705,3692,1852,793,432,1221,1596,8343,0.415488,1
540,2001,Milwaukee Bucks*,82,19780,3112,6798,0.458,562,1481,0.379,2550,5317,0.48,1474,1874,0.787,975,2500,3475,1844,672,386,1123,1928,8260,0.417594,1
541,2001,Los Angeles Lakers*,82,19905,3109,6685,0.465,439,1275,0.344,2670,5410,0.494,1594,2333,0.683,1085,2583,3668,1888,564,490,1184,1872,8251,0.414519,1
542,2001,Dallas Mavericks*,82,19805,3085,6716,0.459,517,1357,0.381,2568,5359,0.479,1552,1954,0.794,831,2571,3402,1740,618,492,1141,1907,8239,0.416006,1
543,2001,Toronto Raptors*,82,19955,3048,6972,0.437,429,1164,0.369,2619,5808,0.451,1482,1984,0.747,1118,2529,3647,2004,599,519,1080,1745,8007,0.401253,1
544,2001,Orlando Magic*,82,19955,3013,6873,0.438,490,1346,0.364,2523,5527,0.456,1476,2068,0.714,1069,2450,3519,1803,674,481,1245,2071,7992,0.400501,1
545,2001,Minnesota Timberwolves*,82,19830,3148,6871,0.458,322,901,0.357,2826,5970,0.473,1364,1737,0.785,1002,2470,3472,2083,682,456,1136,1900,7982,0.402521,1
546,2001,Seattle SuperSonics,82,19805,3029,6649,0.456,466,1169,0.399,2563,5480,0.468,1454,1986,0.732,999,2422,3421,1792,657,409,1252,1733,7978,0.402828,0
547,2001,Houston Rockets,82,19830,2943,6494,0.453,504,1412,0.357,2439,5082,0.48,1582,2086,0.758,919,2524,3443,1613,587,358,1204,1657,7972,0.402017,0
548,2001,Utah Jazz*,82,19780,2960,6289,0.471,325,852,0.381,2635,5437,0.485,1714,2280,0.752,943,2383,3326,2110,661,463,1296,2107,7959,0.402376,1
549,2001,Denver Nuggets,82,19780,2979,6877,0.433,512,1444,0.355,2467,5433,0.454,1448,1964,0.737,1044,2583,3627,1970,552,538,1136,1820,7918,0.400303,0
550,2001,San Antonio Spurs*,82,19830,2884,6262,0.461,445,1094,0.407,2439,5168,0.472,1673,2340,0.715,902,2712,3614,1778,568,576,1145,1551,7886,0.397680,1
551,2001,Detroit Pistons,82,19855,2919,6880,0.424,389,1112,0.35,2530,5768,0.439,1610,2233,0.721,1108,2626,3734,1629,613,447,1304,1955,7837,0.394712,0
552,2001,Portland Trail Blazers*,82,19780,3004,6417,0.468,369,1057,0.349,2635,5360,0.492,1447,1899,0.762,960,2481,3441,1963,672,419,1257,1745,7824,0.395551,1
553,2001,Philadelphia 76ers*,82,19855,2902,6487,0.447,262,803,0.326,2640,5684,0.464,1697,2277,0.745,1075,2600,3675,1692,690,408,1292,1673,7763,0.390985,1
554,2001,Boston Celtics,82,19830,2773,6485,0.428,592,1633,0.363,2181,4852,0.45,1621,2190,0.74,897,2367,3264,1708,769,336,1285,1952,7759,0.391276,0
555,2001,Phoenix Suns*,82,19805,2944,6757,0.436,332,1054,0.315,2612,5703,0.458,1490,1973,0.755,970,2529,3499,1905,775,429,1250,1864,7710,0.389296,1
556,2001,Washington Wizards,82,19680,2833,6453,0.439,275,848,0.324,2558,5605,0.456,1704,2245,0.759,1016,2370,3386,1647,630,383,1391,1913,7645,0.388465,0
557,2001,Indiana Pacers*,82,19980,2828,6431,0.44,396,1159,0.342,2432,5272,0.461,1539,2009,0.766,921,2595,3516,1763,563,487,1244,1926,7591,0.379930,1
558,2001,Golden State Warriors,82,19780,2937,7175,0.409,282,964,0.293,2655,6211,0.427,1428,2024,0.706,1345,2385,3730,1788,742,410,1301,1727,7584,0.383418,0
559,2001,Los Angeles Clippers,82,20030,2896,6467,0.448,360,1063,0.339,2536,5404,0.469,1429,2061,0.693,962,2559,3521,1585,490,513,1293,1775,7581,0.378482,0
560,2001,Cleveland Cavaliers,82,19830,2890,6532,0.442,220,659,0.334,2670,5873,0.455,1561,2040,0.765,1015,2440,3455,1708,642,436,1350,1904,7561,0.381291,0
561,2001,New Jersey Nets,82,19730,2781,6550,0.425,361,1084,0.333,2420,5466,0.443,1629,2146,0.759,909,2337,3246,1603,649,407,1208,1982,7552,0.382767,0
562,2001,Charlotte Hornets*,82,19880,2800,6501,0.431,340,984,0.346,2460,5517,0.446,1599,2146,0.745,1033,2608,3641,1900,665,455,1183,1753,7539,0.379225,1
563,2001,Vancouver Grizzlies,82,19780,2870,6539,0.439,325,947,0.343,2545,5592,0.455,1457,1892,0.77,894,2431,3325,1899,586,359,1291,1733,7522,0.380283,0
564,2001,Atlanta Hawks,82,19730,2876,6668,0.431,333,933,0.357,2543,5735,0.443,1374,1811,0.759,1028,2490,3518,1559,634,387,1368,1863,7459,0.378054,0
565,2001,Miami Heat*,82,19880,2694,6258,0.43,478,1384,0.345,2216,4874,0.455,1423,1874,0.759,813,2435,3248,1630,633,304,1122,1726,7289,0.366650,1
566,2001,New York Knicks*,82,19905,2755,6198,0.444,391,1115,0.351,2364,5083,0.465,1374,1727,0.796,773,2524,3297,1520,545,346,1189,1863,7275,0.365486,1
567,2001,Chicago Bulls,82,19855,2721,6411,0.424,329,950,0.346,2392,5461,0.438,1410,1909,0.739,926,2260,3186,1810,675,379,1292,1902,7181,0.361672,0
568,2002,Dallas Mavericks*,82,19880,3200,6930,0.462,621,1645,0.378,2579,5285,0.488,1608,1994,0.806,918,2568,3486,1811,581,392,992,1842,8629,0.434054,1
569,2002,Sacramento Kings*,82,19755,3267,7003,0.467,426,1160,0.367,2841,5843,0.486,1618,2154,0.751,1013,2702,3715,1958,741,375,1128,1560,8578,0.434219,1
570,2002,Los Angeles Lakers*,82,19780,3150,6840,0.461,510,1439,0.354,2640,5401,0.489,1494,2138,0.699,1022,2607,3629,1882,625,478,1040,1823,8304,0.419818,1
571,2002,Orlando Magic*,82,19830,3087,6893,0.448,620,1660,0.373,2467,5233,0.471,1446,1917,0.754,942,2440,3382,1804,665,384,1119,1700,8240,0.415532,1
572,2002,Minnesota Timberwolves*,82,19805,3175,6887,0.461,396,1047,0.378,2779,5840,0.476,1399,1754,0.798,1059,2562,3621,1993,524,427,1097,1739,8145,0.411260,1
573,2002,Seattle SuperSonics*,82,19830,3131,6681,0.469,489,1292,0.378,2642,5389,0.49,1263,1672,0.755,968,2333,3301,1926,698,364,1124,1732,8014,0.404135,1
574,2002,Golden State Warriors,82,19780,2998,6989,0.429,320,994,0.322,2678,5995,0.447,1693,2344,0.722,1334,2493,3827,1706,650,523,1378,1884,8009,0.404904,0
575,2002,Milwaukee Bucks,82,19905,3041,6577,0.462,593,1583,0.375,2448,4994,0.49,1321,1767,0.748,841,2557,3398,1847,596,388,1157,1788,7996,0.401708,0
576,2002,Indiana Pacers*,82,19905,2935,6580,0.446,405,1195,0.339,2530,5385,0.47,1663,2155,0.772,930,2568,3498,1884,658,436,1249,1876,7938,0.398794,1
577,2002,San Antonio Spurs*,82,19855,2913,6363,0.458,438,1211,0.362,2475,5152,0.48,1668,2249,0.742,907,2566,3473,1643,625,537,1180,1575,7932,0.399496,1
578,2002,Portland Trail Blazers*,82,19830,3004,6671,0.45,466,1318,0.354,2538,5353,0.474,1451,1901,0.763,1085,2444,3529,1926,702,368,1172,1613,7925,0.399647,1
579,2002,Boston Celtics*,82,19830,2852,6731,0.424,699,1946,0.359,2153,4785,0.45,1498,1960,0.764,891,2570,3461,1722,793,292,1114,1776,7901,0.398437,1
580,2002,New Jersey Nets*,82,19830,3042,6816,0.446,403,1194,0.338,2639,5622,0.469,1402,1907,0.735,1039,2515,3554,1990,716,490,1189,1734,7889,0.397832,1
581,2002,Utah Jazz*,82,19830,2869,6374,0.45,280,842,0.333,2589,5532,0.468,1853,2430,0.763,1109,2349,3458,1999,749,523,1353,1971,7871,0.396924,1
582,2002,Los Angeles Clippers,82,19805,2970,6668,0.445,408,1147,0.356,2562,5521,0.464,1498,2026,0.739,1083,2474,3557,1714,510,540,1214,1624,7846,0.396163,0
583,2002,Cleveland Cavaliers,82,19855,2948,6582,0.448,387,1026,0.377,2561,5556,0.461,1529,1980,0.772,968,2483,3451,1891,572,470,1196,1752,7812,0.393453,0
584,2002,Phoenix Suns,82,19830,3097,6934,0.447,358,1096,0.327,2739,5838,0.469,1250,1630,0.767,1072,2430,3502,1838,668,401,1205,1785,7802,0.393444,0
585,2002,Detroit Pistons*,82,19680,2845,6300,0.452,567,1509,0.376,2278,4791,0.475,1478,1954,0.756,810,2366,3176,1765,648,565,1193,1695,7735,0.393039,1
586,2002,Atlanta Hawks,82,19780,2901,6610,0.439,423,1194,0.354,2478,5416,0.458,1486,1942,0.765,955,2445,3400,1656,667,350,1275,1702,7711,0.389838,0
587,2002,Charlotte Hornets*,82,19755,2893,6580,0.44,346,994,0.348,2547,5586,0.456,1568,2105,0.745,1059,2505,3564,1759,653,456,1150,1747,7700,0.389775,1
588,2002,Washington Wizards,82,19730,2938,6664,0.441,305,786,0.388,2633,5878,0.448,1428,1866,0.765,1055,2393,3448,1715,570,354,1068,1763,7609,0.385656,0
589,2002,Houston Rockets,82,19980,2837,6629,0.428,496,1480,0.335,2341,5149,0.455,1402,1893,0.741,1025,2411,3436,1482,537,445,1156,1476,7572,0.378979,0
590,2002,Denver Nuggets,82,19805,2915,6870,0.424,423,1285,0.329,2492,5585,0.446,1306,1756,0.744,1117,2310,3427,1817,613,462,1205,1873,7559,0.381671,0
591,2002,New York Knicks,82,19805,2817,6520,0.432,474,1344,0.353,2343,5176,0.453,1406,1786,0.787,876,2458,3334,1720,558,288,1192,1800,7514,0.379399,0
592,2002,Toronto Raptors*,82,19755,2919,6727,0.434,387,1109,0.349,2532,5618,0.451,1269,1717,0.739,1114,2336,3450,1779,688,454,1174,1771,7494,0.379347,1
593,2002,Philadelphia 76ers*,82,19730,2804,6436,0.436,214,715,0.299,2590,5721,0.453,1639,2104,0.779,1092,2534,3626,1638,705,363,1256,1645,7461,0.378155,1
594,2002,Memphis Grizzlies,82,19780,2851,6535,0.436,336,1096,0.307,2515,5439,0.462,1334,1883,0.708,984,2413,3397,1785,646,488,1344,1571,7372,0.372700,0
595,2002,Chicago Bulls,82,19805,2811,6491,0.433,300,868,0.346,2511,5623,0.447,1413,1958,0.722,924,2359,3283,1817,633,361,1252,1834,7335,0.370361,0
596,2002,Miami Heat,82,19930,2801,6382,0.439,312,899,0.347,2489,5483,0.454,1236,1708,0.724,902,2544,3446,1664,547,448,1217,1846,7150,0.358756,0
597,2003,Dallas Mavericks*,82,19780,3161,6982,0.453,636,1668,0.381,2525,5314,0.475,1486,1793,0.829,912,2544,3456,1837,665,449,949,1730,8444,0.426896,1
598,2003,Golden State Warriors,82,19755,3061,6941,0.441,425,1235,0.344,2636,5706,0.462,1853,2382,0.778,1284,2546,3830,1712,594,506,1295,1786,8400,0.425209,0
599,2003,Sacramento Kings*,82,19830,3242,6990,0.464,491,1288,0.381,2751,5702,0.482,1367,1832,0.746,900,2751,3651,2034,736,457,1192,1666,8342,0.420676,1
600,2003,Los Angeles Lakers*,82,19930,3091,6856,0.451,486,1367,0.356,2605,5489,0.475,1562,2129,0.734,1078,2554,3632,1909,639,470,1192,1874,8230,0.412945,1
601,2003,Milwaukee Bucks*,82,19905,3045,6670,0.457,585,1526,0.383,2460,5144,0.478,1483,1911,0.776,876,2367,3243,1823,622,344,1044,1820,8158,0.409847,1
602,2003,Orlando Magic*,82,19805,2947,6763,0.436,568,1590,0.357,2379,5173,0.46,1616,2079,0.777,958,2392,3350,1676,696,300,1177,1888,8078,0.407877,1
603,2003,Minnesota Timberwolves*,82,19805,3172,6809,0.466,296,804,0.368,2876,6005,0.479,1406,1826,0.77,959,2614,3573,2070,553,433,1124,1704,8046,0.406261,1
604,2003,Memphis Grizzlies,82,19930,3049,6743,0.452,467,1279,0.365,2582,5464,0.473,1430,1936,0.739,943,2466,3409,1892,651,500,1262,1678,7995,0.401154,0
605,2003,Philadelphia 76ers*,82,19855,2975,6640,0.448,245,787,0.311,2730,5853,0.466,1746,2253,0.775,1042,2415,3457,1771,844,284,1212,1804,7941,0.399950,1
606,2003,Indiana Pacers*,82,19905,2911,6608,0.441,379,1119,0.339,2532,5489,0.461,1739,2271,0.766,1004,2622,3626,1910,696,443,1210,1811,7940,0.398895,1
607,2003,New York Knicks,82,19855,2967,6725,0.441,606,1582,0.383,2361,5143,0.459,1320,1620,0.815,842,2376,3218,1800,579,255,1149,1888,7860,0.395870,0
608,2003,San Antonio Spurs*,82,19830,2908,6297,0.462,449,1270,0.354,2459,5027,0.489,1591,2194,0.725,939,2556,3495,1636,629,529,1295,1672,7856,0.396167,1
609,2003,Phoenix Suns*,82,19805,3005,6776,0.443,394,1149,0.343,2611,5627,0.464,1430,1928,0.742,1049,2440,3489,1719,665,404,1208,1801,7834,0.395557,1
610,2003,New Jersey Nets*,82,19755,2906,6585,0.441,346,1041,0.332,2560,5544,0.462,1662,2195,0.757,991,2528,3519,1887,717,374,1212,1772,7820,0.395849,1
611,2003,Portland Trail Blazers*,82,19855,2987,6491,0.46,379,1150,0.33,2608,5341,0.488,1450,1947,0.745,992,2378,3370,1860,725,316,1248,1634,7803,0.392999,1
612,2003,Chicago Bulls,82,19930,2991,6714,0.445,349,997,0.35,2642,5717,0.462,1455,2014,0.722,985,2541,3526,1782,605,461,1388,2028,7786,0.390667,0
613,2003,Utah Jazz*,82,19780,2894,6189,0.468,224,641,0.349,2670,5548,0.481,1750,2349,0.745,1021,2381,3402,2103,708,467,1374,1837,7762,0.392417,1
614,2003,Atlanta Hawks,82,19905,2859,6434,0.444,402,1141,0.352,2457,5293,0.464,1594,2011,0.793,937,2558,3495,1679,611,473,1367,1783,7714,0.387541,0
615,2003,New Orleans Hornets*,82,19905,2914,6695,0.435,404,1075,0.376,2510,5620,0.447,1467,1910,0.768,1097,2475,3572,1807,656,394,1212,1769,7699,0.386787,1
616,2003,Los Angeles Clippers,82,19755,2835,6490,0.437,390,1178,0.331,2445,5312,0.46,1633,2177,0.75,1008,2462,3470,1605,574,461,1291,1784,7693,0.389420,0
617,2003,Houston Rockets,82,19930,2840,6461,0.44,439,1267,0.346,2401,5194,0.462,1569,2044,0.768,1024,2564,3588,1506,594,493,1276,1602,7688,0.385750,0
618,2003,Boston Celtics*,82,19830,2700,6509,0.415,719,2155,0.334,1981,4354,0.455,1480,1994,0.742,849,2471,3320,1575,720,303,1147,1758,7599,0.383207,1
619,2003,Seattle SuperSonics,82,19855,2887,6599,0.437,456,1291,0.353,2431,5308,0.458,1325,1780,0.744,963,2385,3348,1775,679,295,1085,1712,7555,0.380509,0
620,2003,Washington Wizards,82,19830,2816,6394,0.44,253,811,0.312,2563,5583,0.459,1617,2077,0.779,917,2395,3312,1612,621,390,1095,1644,7502,0.378316,0
621,2003,Cleveland Cavaliers,82,19830,2850,6746,0.422,293,896,0.327,2557,5850,0.437,1502,2012,0.747,1118,2542,3660,1712,636,521,1501,1864,7495,0.377963,0
622,2003,Detroit Pistons*,82,19905,2700,6277,0.43,533,1488,0.358,2167,4789,0.452,1559,2021,0.771,883,2445,3328,1620,556,468,1104,1748,7492,0.376388,1
623,2003,Toronto Raptors,82,19805,2847,6664,0.427,409,1193,0.343,2438,5471,0.446,1350,1879,0.718,1023,2355,3378,1583,609,392,1181,1761,7453,0.376319,0
624,2003,Miami Heat,82,19830,2688,6517,0.412,348,1100,0.316,2340,5417,0.432,1292,1689,0.765,948,2464,3412,1501,592,324,1167,1856,7016,0.353807,0
625,2003,Denver Nuggets,82,19730,2689,6544,0.411,229,824,0.278,2460,5720,0.43,1294,1850,0.699,1112,2363,3475,1737,712,422,1514,2056,6901,0.349772,0
626,2004,Dallas Mavericks*,82,19805,3322,7230,0.459,507,1456,0.348,2815,5774,0.488,1475,1854,0.796,1174,2538,3712,1963,656,437,1000,1609,8626,0.435547,1
627,2004,Sacramento Kings*,82,19780,3103,6711,0.462,601,1498,0.401,2502,5213,0.48,1626,2044,0.795,888,2492,3380,2152,710,325,1137,1586,8433,0.426340,1
628,2004,Los Angeles Lakers*,82,19855,3028,6676,0.454,365,1115,0.327,2663,5561,0.479,1631,2352,0.693,1001,2535,3536,1948,682,379,1132,1732,8052,0.405540,1
629,2004,Milwaukee Bucks*,82,19780,2970,6650,0.447,401,1145,0.35,2569,5505,0.467,1698,2192,0.775,960,2502,3462,1872,554,383,1110,1668,8039,0.406421,1
630,2004,Denver Nuggets*,82,19730,2993,6763,0.443,331,985,0.336,2662,5778,0.461,1655,2159,0.767,1083,2387,3470,1794,745,520,1278,1804,7972,0.404055,1
631,2004,Seattle SuperSonics,82,19805,2939,6590,0.446,723,1936,0.373,2216,4654,0.476,1363,1782,0.765,907,2318,3225,1782,661,387,1188,1784,7964,0.402121,0
632,2004,Memphis Grizzlies*,82,19880,2963,6657,0.445,447,1314,0.34,2516,5343,0.471,1557,2143,0.727,1047,2381,3428,1915,795,565,1226,1903,7930,0.398893,1
633,2004,Boston Celtics*,82,19705,2843,6415,0.443,553,1599,0.346,2290,4816,0.475,1572,2095,0.75,851,2440,3291,1683,770,331,1332,1837,7811,0.396397,1
634,2004,Los Angeles Clippers,82,19805,2817,6579,0.428,329,1024,0.321,2488,5555,0.448,1808,2302,0.785,1149,2416,3565,1653,594,376,1344,1816,7771,0.392376,0
635,2004,Minnesota Timberwolves*,82,19755,3033,6571,0.462,326,897,0.363,2707,5674,0.477,1361,1743,0.781,875,2645,3520,1890,561,462,1043,1731,7753,0.392458,1
636,2004,Phoenix Suns,82,19730,2958,6671,0.443,415,1202,0.345,2543,5469,0.465,1392,1865,0.746,924,2406,3330,1586,734,383,1249,1862,7723,0.391434,0
637,2004,Orlando Magic,82,19830,2904,6768,0.429,429,1248,0.344,2475,5520,0.448,1474,2000,0.737,1003,2350,3353,1584,547,308,1123,1744,7711,0.388855,0
638,2004,Golden State Warriors,82,19855,2875,6511,0.442,429,1283,0.334,2446,5228,0.468,1470,2028,0.725,1002,2533,3535,1681,576,389,1211,1691,7649,0.385243,0
639,2004,Cleveland Cavaliers,82,19855,2922,6753,0.433,247,786,0.314,2675,5967,0.448,1528,2030,0.753,1118,2619,3737,1808,585,537,1216,1743,7619,0.383732,0
640,2004,Atlanta Hawks,82,19905,2829,6529,0.433,419,1249,0.335,2410,5280,0.456,1534,1976,0.776,996,2507,3503,1648,627,408,1350,1826,7611,0.382366,0
641,2004,New York Knicks*,82,19880,2881,6513,0.442,406,1115,0.364,2475,5398,0.459,1374,1732,0.793,950,2543,3493,1695,608,391,1289,1897,7542,0.379376,1
642,2004,New Orleans Hornets*,82,19830,2772,6605,0.42,531,1666,0.319,2241,4939,0.454,1454,1937,0.751,1091,2418,3509,1716,708,346,1228,1715,7529,0.379677,1
643,2004,Washington Wizards,82,19830,2758,6556,0.421,433,1269,0.341,2325,5287,0.44,1579,2211,0.714,1115,2392,3507,1537,733,406,1439,1712,7528,0.379627,0
644,2004,San Antonio Spurs*,82,19755,2842,6434,0.442,408,1140,0.358,2434,5294,0.46,1409,2069,0.681,1029,2669,3698,1676,661,537,1203,1667,7501,0.379701,1
645,2004,Indiana Pacers*,82,19805,2753,6322,0.435,449,1281,0.351,2304,5041,0.457,1538,2014,0.764,965,2452,3417,1774,726,411,1182,1709,7493,0.378339,1
646,2004,Portland Trail Blazers,82,19980,2898,6467,0.448,381,1102,0.346,2517,5365,0.469,1263,1728,0.731,1040,2376,3416,1768,613,443,1213,1554,7440,0.372372,0
647,2004,Miami Heat*,82,19755,2729,6417,0.425,485,1357,0.357,2244,5060,0.443,1459,1915,0.762,940,2459,3399,1565,590,313,1137,1812,7402,0.374690,1
648,2004,New Jersey Nets*,82,19705,2813,6372,0.441,377,1123,0.336,2436,5249,0.464,1398,1856,0.753,862,2473,3335,2009,709,322,1209,1722,7401,0.375590,1
649,2004,Detroit Pistons*,82,19780,2747,6314,0.435,333,968,0.344,2414,5346,0.452,1561,2074,0.753,1014,2492,3506,1702,659,570,1241,1664,7388,0.373509,1
650,2004,Houston Rockets*,82,19930,2738,6195,0.442,515,1406,0.366,2223,4789,0.464,1371,1774,0.773,847,2647,3494,1579,560,443,1373,1762,7362,0.369393,1
651,2004,Chicago Bulls,82,19830,2798,6753,0.414,429,1256,0.342,2369,5497,0.431,1330,1834,0.725,1048,2519,3567,1793,659,396,1321,1911,7355,0.370903,0
652,2004,Utah Jazz,82,19780,2690,6172,0.436,252,786,0.321,2438,5386,0.453,1639,2196,0.746,1103,2272,3375,1671,583,494,1365,2096,7271,0.367594,0
653,2004,Philadelphia 76ers,82,19855,2682,6260,0.428,339,992,0.342,2343,5268,0.445,1512,2009,0.753,941,2408,3349,1640,654,358,1307,1701,7215,0.363385,0
654,2004,Toronto Raptors,82,19980,2654,6348,0.418,461,1294,0.356,2193,5054,0.434,1237,1650,0.75,830,2419,3249,1574,604,402,1164,1748,7006,0.350651,0
655,2005,Phoenix Suns*,82,19780,3351,7018,0.477,796,2026,0.393,2555,4992,0.512,1556,2080,0.748,967,2652,3619,1927,572,453,1125,1563,9054,0.457735,1
656,2005,Sacramento Kings*,82,19855,3203,6978,0.459,522,1396,0.374,2681,5582,0.48,1577,2004,0.787,1023,2455,3478,2005,674,316,1073,1685,8505,0.428356,1
657,2005,Dallas Mavericks*,82,19730,3058,6691,0.457,463,1273,0.364,2595,5418,0.479,1826,2314,0.789,990,2530,3520,1610,708,461,1102,1827,8405,0.426001,1
658,2005,Miami Heat*,82,19980,3097,6368,0.486,475,1260,0.377,2622,5108,0.513,1658,2466,0.672,887,2639,3526,1790,528,474,1127,1814,8327,0.416767,1
659,2005,Boston Celtics*,82,19880,3046,6511,0.468,437,1252,0.349,2609,5259,0.496,1775,2323,0.764,909,2438,3347,1810,667,423,1297,2000,8304,0.417706,1
660,2005,Washington Wizards*,82,19780,2966,6794,0.437,514,1498,0.343,2452,5296,0.463,1795,2476,0.725,1133,2374,3507,1563,716,347,1172,1807,8241,0.416633,1
661,2005,Toronto Raptors,82,19805,2952,6656,0.444,648,1681,0.385,2304,4975,0.463,1626,2101,0.774,844,2444,3288,1670,621,317,1087,1876,8178,0.412926,0
662,2005,Denver Nuggets*,82,19755,3038,6615,0.459,320,940,0.34,2718,5675,0.479,1765,2313,0.763,967,2473,3440,1958,750,489,1224,1878,8161,0.413111,1
663,2005,Orlando Magic,82,19705,3034,6679,0.454,320,916,0.349,2714,5763,0.471,1772,2335,0.759,1038,2544,3582,1583,633,441,1322,1937,8160,0.414108,0
664,2005,Philadelphia 76ers*,82,19855,2946,6736,0.437,505,1453,0.348,2441,5283,0.462,1731,2194,0.789,909,2536,3445,1710,756,321,1274,1878,8128,0.409368,1
665,2005,Seattle SuperSonics*,82,19755,2882,6498,0.444,666,1824,0.365,2216,4674,0.474,1683,2131,0.79,1041,2311,3352,1487,553,338,1113,1944,8113,0.410681,1
666,2005,Los Angeles Lakers,82,19780,2895,6629,0.437,644,1813,0.355,2251,4816,0.467,1661,2137,0.777,1028,2511,3539,1672,508,344,1176,1794,8095,0.409252,0
667,2005,Golden State Warriors,82,19905,3029,7039,0.43,624,1774,0.352,2405,5265,0.457,1412,1955,0.722,1069,2436,3505,1811,642,420,1112,1833,8094,0.406631,0
668,2005,New York Knicks,82,19880,2978,6599,0.451,441,1240,0.356,2537,5359,0.473,1580,2060,0.767,965,2393,3358,1665,629,260,1204,1942,7977,0.401258,0
669,2005,Milwaukee Bucks,82,19780,2964,6580,0.45,325,925,0.351,2639,5655,0.467,1720,2229,0.772,985,2405,3390,1720,529,289,1132,1797,7973,0.403084,0
670,2005,Minnesota Timberwolves,82,19755,3045,6629,0.459,395,1145,0.345,2650,5484,0.483,1449,1820,0.796,947,2580,3527,1918,460,447,1079,1774,7934,0.401620,0
671,2005,Cleveland Cavaliers,82,19855,2990,6687,0.447,300,904,0.332,2690,5783,0.465,1634,2174,0.752,1117,2352,3469,1851,654,461,1141,1850,7914,0.398590,0
672,2005,San Antonio Spurs*,82,19805,2923,6450,0.453,507,1395,0.363,2416,5055,0.478,1535,2120,0.724,987,2489,3476,1771,613,543,1126,1717,7888,0.398283,1
673,2005,Los Angeles Clippers,82,20030,2924,6368,0.459,231,669,0.345,2693,5699,0.473,1770,2274,0.778,980,2455,3435,1901,599,422,1290,1819,7849,0.391862,0
674,2005,Houston Rockets*,82,19855,2846,6419,0.443,553,1521,0.364,2293,4898,0.468,1551,1986,0.781,874,2601,3475,1733,563,378,1135,1807,7796,0.392647,1
675,2005,Chicago Bulls*,82,19830,2849,6592,0.432,511,1433,0.357,2338,5159,0.453,1536,2048,0.75,1001,2591,3592,1743,576,369,1371,2028,7745,0.390570,1
676,2005,Charlotte Bobcats,82,19880,2961,6859,0.432,320,881,0.363,2641,5978,0.442,1487,2096,0.709,1083,2335,3418,1794,695,440,1192,1894,7729,0.388783,0
677,2005,Memphis Grizzlies*,82,19705,2802,6271,0.447,531,1486,0.357,2271,4785,0.475,1526,2024,0.754,887,2307,3194,1716,699,476,1197,1910,7661,0.388785,1
678,2005,Detroit Pistons*,82,19955,2851,6421,0.444,363,1053,0.345,2488,5368,0.463,1588,2150,0.739,1054,2507,3561,1787,576,497,1133,1638,7653,0.383513,1
679,2005,Indiana Pacers*,82,19905,2668,6169,0.432,542,1575,0.344,2126,4594,0.463,1748,2206,0.792,868,2418,3286,1489,615,357,1173,1890,7626,0.383120,1
680,2005,Utah Jazz,82,19780,2828,6301,0.449,250,762,0.328,2578,5539,0.465,1719,2272,0.757,1047,2243,3290,1826,541,374,1292,2189,7625,0.385490,0
681,2005,Portland Trail Blazers,82,19730,2896,6422,0.451,420,1161,0.362,2476,5261,0.471,1409,1944,0.725,970,2404,3374,1722,583,544,1308,1703,7621,0.386265,0
682,2005,Atlanta Hawks,82,19855,2942,6672,0.441,304,973,0.312,2638,5699,0.463,1417,1994,0.711,1100,2335,3435,1614,629,344,1319,2009,7605,0.383027,0
683,2005,New Jersey Nets*,82,19905,2753,6419,0.429,435,1203,0.362,2318,5216,0.444,1555,2039,0.763,855,2387,3242,1772,650,308,1164,1985,7496,0.376589,1
684,2005,New Orleans Hornets,82,19930,2718,6556,0.415,415,1316,0.315,2303,5240,0.44,1401,1830,0.766,1019,2281,3300,1724,550,310,1217,1883,7252,0.363874,0
685,2006,Phoenix Suns*,82,19955,3430,7167,0.479,837,2097,0.399,2593,5070,0.511,1189,1475,0.806,778,2650,3428,2179,549,412,1088,1683,8886,0.445302,1
686,2006,Seattle SuperSonics,82,19830,3077,6711,0.459,605,1631,0.371,2472,5080,0.487,1652,2104,0.785,1013,2233,3246,1696,622,306,1208,1933,8411,0.424155,0
687,2006,Washington Wizards*,82,19830,2975,6656,0.447,497,1394,0.357,2478,5262,0.471,1889,2496,0.757,1035,2344,3379,1523,658,339,1143,1855,8336,0.420373,1
688,2006,Toronto Raptors,82,19955,3013,6639,0.454,608,1620,0.375,2405,5019,0.479,1653,2089,0.791,864,2291,3155,1593,529,272,1071,1965,8287,0.415284,0
689,2006,Denver Nuggets*,82,19930,3078,6672,0.461,350,1076,0.325,2728,5596,0.487,1721,2312,0.744,903,2486,3389,1921,698,463,1216,1863,8227,0.412795,1
690,2006,Miami Heat*,82,19755,3039,6355,0.478,497,1441,0.345,2542,4914,0.517,1616,2310,0.7,858,2675,3533,1692,522,442,1186,1871,8191,0.414629,1
691,2006,Los Angeles Lakers*,82,19855,2992,6607,0.453,552,1583,0.349,2440,5024,0.486,1618,2172,0.745,970,2488,3458,1734,628,350,1143,1894,8154,0.410677,1
692,2006,Philadelphia 76ers,82,19905,3001,6546,0.458,375,1031,0.364,2626,5515,0.476,1770,2330,0.76,873,2425,3298,1653,651,404,1159,1712,8147,0.409294,0
693,2006,Dallas Mavericks*,82,19880,2948,6375,0.462,416,1113,0.374,2532,5262,0.481,1818,2322,0.783,1030,2431,3461,1473,593,488,1112,1834,8130,0.408954,1
694,2006,Sacramento Kings*,82,19830,2954,6500,0.454,494,1408,0.351,2460,5092,0.483,1704,2173,0.784,852,2473,3325,1825,608,299,1199,1672,8106,0.408775,1
695,2006,Golden State Warriors,82,19830,2939,6785,0.433,625,1832,0.341,2314,4953,0.467,1573,2190,0.718,980,2485,3465,1694,604,357,1156,1941,8076,0.407262,0
696,2006,Boston Celtics,82,19880,2951,6322,0.467,467,1290,0.362,2484,5032,0.494,1664,2204,0.755,813,2432,3245,1716,578,422,1359,2033,8033,0.404074,0
697,2006,Milwaukee Bucks*,82,19855,2976,6566,0.453,507,1335,0.38,2469,5231,0.472,1561,2115,0.738,929,2448,3377,1769,597,270,1197,1902,8020,0.403928,1
698,2006,Chicago Bulls*,82,19905,3004,6737,0.446,560,1477,0.379,2444,5260,0.465,1452,1967,0.738,906,2602,3508,1804,508,345,1224,2038,8020,0.402914,1
699,2006,Cleveland Cavaliers*,82,19830,2908,6412,0.454,497,1465,0.339,2411,4947,0.487,1689,2318,0.729,959,2511,3470,1560,567,392,1137,1733,8002,0.403530,1
700,2006,Atlanta Hawks,82,19880,2946,6496,0.454,424,1154,0.367,2522,5342,0.472,1656,2207,0.75,1069,2232,3301,1625,587,394,1284,2054,7972,0.401006,0
701,2006,Los Angeles Clippers*,82,19805,2993,6443,0.465,290,843,0.344,2703,5600,0.483,1694,2142,0.791,828,2704,3532,1708,534,503,1185,1872,7970,0.402424,1
702,2006,Charlotte Bobcats,82,19905,2961,6843,0.433,428,1261,0.339,2533,5582,0.454,1593,2186,0.729,990,2270,3260,1717,822,354,1167,1960,7943,0.399045,0
703,2006,Detroit Pistons*,82,19830,2983,6558,0.455,557,1451,0.384,2426,5107,0.475,1418,1950,0.727,975,2347,3322,1971,580,490,931,1513,7941,0.400454,1
704,2006,New York Knicks,82,19930,2822,6206,0.455,320,884,0.362,2502,5322,0.47,1878,2587,0.726,1034,2360,3394,1468,555,271,1449,2157,7842,0.393477,0
705,2006,San Antonio Spurs*,82,19805,2993,6342,0.472,524,1362,0.385,2469,4980,0.496,1327,1891,0.702,851,2548,3399,1717,543,467,1126,1714,7837,0.395708,1
706,2006,Orlando Magic,82,19905,2911,6167,0.472,299,796,0.376,2612,5371,0.486,1663,2277,0.73,892,2402,3294,1495,532,362,1240,1908,7784,0.391058,0
707,2006,Indiana Pacers*,82,19730,2786,6274,0.444,536,1536,0.349,2250,4738,0.475,1591,2158,0.737,898,2559,3457,1631,598,409,1254,1821,7699,0.390218,1
708,2006,New Jersey Nets*,82,19780,2778,6317,0.44,477,1447,0.33,2301,4870,0.472,1658,2187,0.758,822,2539,3361,1884,558,278,1119,1903,7691,0.388827,1
709,2006,New Orleans/Oklahoma City Hornets,82,19805,2831,6428,0.44,300,885,0.339,2531,5543,0.457,1649,2176,0.758,918,2379,3297,1519,611,311,1095,1786,7611,0.384297,0
710,2006,Utah Jazz,82,19880,2744,6207,0.442,311,925,0.336,2433,5282,0.461,1774,2466,0.719,1071,2380,3451,1772,524,492,1290,2032,7573,0.380936,0
711,2006,Memphis Grizzlies*,82,19855,2746,6125,0.448,590,1578,0.374,2156,4547,0.474,1476,2077,0.711,834,2379,3213,1586,600,442,1134,1757,7558,0.380660,1
712,2006,Minnesota Timberwolves,82,19855,2888,6340,0.456,310,942,0.329,2578,5398,0.478,1436,1895,0.758,811,2422,3233,1716,559,471,1189,1889,7522,0.378847,0
713,2006,Houston Rockets,82,19830,2708,6252,0.433,469,1414,0.332,2239,4838,0.463,1502,1980,0.759,849,2565,3414,1580,588,320,1193,1863,7387,0.372516,0
714,2006,Portland Trail Blazers,82,19730,2791,6267,0.445,364,1042,0.349,2427,5225,0.464,1339,1944,0.689,886,2203,3089,1490,529,435,1205,1828,7285,0.369235,0
715,2007,Phoenix Suns*,82,19905,3388,6855,0.494,785,1965,0.399,2603,4890,0.532,1476,1827,0.808,737,2583,3320,2122,553,394,1189,1659,9037,0.454007,1
716,2007,Golden State Warriors*,82,19755,3261,7048,0.463,700,1967,0.356,2561,5081,0.504,1515,2113,0.717,940,2456,3396,1950,750,466,1309,1933,8737,0.442268,1
717,2007,Denver Nuggets*,82,19780,3164,6805,0.465,484,1440,0.336,2680,5365,0.5,1827,2449,0.746,1001,2558,3559,1920,678,435,1352,1756,8639,0.436754,1
718,2007,Washington Wizards*,82,19830,3070,6820,0.45,561,1614,0.348,2509,5206,0.482,1855,2425,0.765,998,2379,3377,1660,635,375,1133,1823,8556,0.431467,1
719,2007,Los Angeles Lakers*,82,20030,3103,6664,0.466,608,1724,0.353,2495,4940,0.505,1660,2221,0.747,886,2495,3381,1850,600,421,1273,1889,8474,0.423065,1
720,2007,Memphis Grizzlies,82,19980,2998,6448,0.465,500,1362,0.367,2498,5086,0.491,1835,2410,0.761,866,2375,3241,1680,564,407,1343,1827,8331,0.416967,0
721,2007,Utah Jazz*,82,19805,3069,6471,0.474,354,1056,0.335,2715,5415,0.501,1830,2462,0.743,1030,2456,3486,2024,577,339,1277,2067,8322,0.420197,1
722,2007,Sacramento Kings,82,19805,2941,6532,0.45,530,1513,0.35,2411,5019,0.48,1891,2473,0.765,797,2396,3193,1665,671,265,1194,1792,8303,0.419238,0
723,2007,Dallas Mavericks*,82,19755,3010,6442,0.467,535,1404,0.381,2475,5038,0.491,1646,2045,0.805,920,2515,3435,1632,560,408,1140,1837,8201,0.415135,1
724,2007,Milwaukee Bucks,82,19855,3121,6714,0.465,524,1472,0.356,2597,5242,0.495,1406,1919,0.733,941,2272,3213,1771,587,224,1240,1821,8172,0.411584,0
725,2007,Toronto Raptors*,82,19755,3032,6547,0.463,531,1464,0.363,2501,5083,0.492,1562,1982,0.788,755,2480,3235,1822,581,321,1104,1672,8157,0.412908,1
726,2007,Seattle SuperSonics,82,19830,3047,6628,0.46,525,1451,0.362,2522,5177,0.487,1511,1911,0.791,928,2322,3250,1695,631,301,1268,1801,8130,0.409985,0
727,2007,Chicago Bulls*,82,19780,3046,6663,0.457,480,1237,0.388,2566,5426,0.473,1528,2083,0.734,984,2597,3581,1832,639,445,1310,1908,8100,0.409505,1
728,2007,San Antonio Spurs*,82,19780,2999,6328,0.474,595,1561,0.381,2404,4767,0.504,1486,1980,0.751,761,2577,3338,1814,587,417,1137,1588,8079,0.408443,1
729,2007,New Jersey Nets*,82,19880,2913,6379,0.457,609,1676,0.363,2304,4703,0.49,1566,2153,0.727,822,2525,3347,1962,499,273,1212,1869,8001,0.402465,1
730,2007,New York Knicks,82,20005,2903,6356,0.457,474,1370,0.346,2429,4986,0.487,1714,2396,0.715,1032,2516,3548,1532,543,260,1405,1932,7994,0.399600,0
731,2007,Houston Rockets*,82,19855,2906,6528,0.445,705,1893,0.372,2201,4635,0.475,1436,1906,0.753,880,2673,3553,1704,583,337,1162,1710,7953,0.400554,1
732,2007,Charlotte Bobcats,82,20005,2960,6643,0.446,457,1280,0.357,2503,5363,0.467,1568,2136,0.734,920,2346,3266,1836,638,369,1224,1985,7945,0.397151,0
733,2007,Cleveland Cavaliers*,82,19880,2978,6658,0.447,494,1404,0.352,2484,5254,0.473,1484,2133,0.696,1039,2529,3568,1708,625,353,1177,1781,7934,0.399095,1
734,2007,Minnesota Timberwolves,82,20005,2997,6503,0.461,384,1089,0.353,2613,5414,0.483,1499,1892,0.792,819,2474,3293,1848,532,325,1278,1758,7877,0.393752,0
735,2007,Detroit Pistons*,82,19880,2942,6484,0.454,449,1305,0.344,2493,5179,0.481,1539,1988,0.774,948,2374,3322,1768,583,472,1001,1672,7872,0.395976,1
736,2007,Boston Celtics,82,19855,2858,6454,0.443,471,1283,0.367,2387,5171,0.462,1670,2178,0.767,918,2391,3309,1630,589,382,1350,1971,7857,0.395719,0
737,2007,Los Angeles Clippers,82,19730,2880,6318,0.456,314,903,0.348,2566,5415,0.474,1769,2245,0.788,888,2484,3372,1762,596,472,1239,1858,7843,0.397516,0
738,2007,Indiana Pacers,82,19780,2872,6561,0.438,481,1389,0.346,2391,5172,0.462,1615,2125,0.76,990,2441,3431,1680,599,447,1335,1912,7840,0.396360,0
739,2007,New Orleans/Oklahoma City Hornets,82,19880,2971,6674,0.445,455,1256,0.362,2516,5418,0.464,1436,1941,0.74,1025,2512,3537,1537,522,347,1187,1620,7833,0.394014,0
740,2007,Philadelphia 76ers,82,19880,2932,6408,0.458,284,823,0.345,2648,5585,0.474,1637,2135,0.767,899,2353,3252,1669,590,390,1258,1671,7785,0.391600,0
741,2007,Orlando Magic*,82,19780,2875,6090,0.472,342,962,0.356,2533,5128,0.494,1679,2393,0.702,920,2418,3338,1525,565,416,1392,1904,7771,0.392872,1
742,2007,Miami Heat*,82,19855,2919,6288,0.464,528,1539,0.343,2391,4749,0.503,1393,2019,0.69,817,2526,3343,1681,566,442,1201,1749,7759,0.390783,1
743,2007,Portland Trail Blazers,82,19955,2874,6392,0.45,426,1232,0.346,2448,5160,0.474,1543,2006,0.769,923,2299,3222,1513,555,380,1236,1931,7717,0.386720,0
744,2007,Atlanta Hawks,82,19880,2831,6372,0.444,341,1038,0.329,2490,5334,0.467,1677,2203,0.761,976,2312,3288,1573,609,446,1306,1970,7680,0.386318,0
745,2008,Golden State Warriors,82,19780,3403,7406,0.459,761,2185,0.348,2642,5221,0.506,1538,2044,0.752,1045,2496,3541,1833,744,377,1082,1875,9105,0.460313,0
746,2008,Denver Nuggets*,82,19855,3307,7038,0.47,569,1605,0.355,2738,5433,0.504,1891,2519,0.751,918,2698,3616,2024,752,551,1203,1731,9074,0.457013,1
747,2008,Phoenix Suns*,82,19780,3392,6782,0.5,694,1764,0.393,2698,5018,0.538,1548,1977,0.783,720,2683,3403,2188,532,518,1184,1633,9026,0.456320,1
748,2008,Los Angeles Lakers*,82,19780,3248,6818,0.476,662,1751,0.378,2586,5067,0.51,1746,2270,0.769,898,2722,3620,2003,654,438,1156,1691,8904,0.450152,1
749,2008,Utah Jazz*,82,19705,3279,6592,0.497,407,1095,0.372,2872,5497,0.522,1745,2298,0.759,942,2410,3352,2165,717,355,1200,1970,8710,0.442020,1
750,2008,Orlando Magic*,82,19780,3058,6446,0.474,801,2074,0.386,2257,4372,0.516,1650,2288,0.721,768,2677,3445,1706,520,333,1173,1688,8567,0.433114,1
751,2008,Indiana Pacers,82,19755,3102,6993,0.444,755,2021,0.374,2347,4972,0.472,1568,2042,0.768,904,2633,3537,1864,623,412,1236,1921,8527,0.431638,0
752,2008,Sacramento Kings,82,19830,3043,6558,0.464,510,1367,0.373,2533,5191,0.488,1812,2272,0.798,829,2456,3285,1567,651,334,1317,1839,8408,0.424004,0
753,2008,New Orleans Hornets*,82,19805,3164,6796,0.466,630,1621,0.389,2534,5175,0.49,1312,1707,0.769,937,2494,3431,1785,637,321,974,1531,8270,0.417571,1
754,2008,Memphis Grizzlies,82,19805,3060,6737,0.454,620,1779,0.349,2440,4958,0.492,1517,2097,0.723,848,2567,3415,1574,503,386,1251,1592,8257,0.416915,0
755,2008,Boston Celtics*,82,19755,2986,6286,0.475,596,1564,0.381,2390,4722,0.506,1677,2176,0.771,830,2615,3445,1833,696,379,1246,1864,8245,0.417363,1
756,2008,Dallas Mavericks*,82,19730,3025,6515,0.464,494,1403,0.352,2531,5112,0.495,1690,2075,0.814,883,2643,3526,1720,490,402,1037,1786,8234,0.417334,1
757,2008,Toronto Raptors*,82,19830,3148,6726,0.468,572,1459,0.392,2576,5267,0.489,1347,1658,0.812,790,2496,3286,1953,570,336,959,1596,8215,0.414271,1
758,2008,Washington Wizards*,82,19905,2986,6695,0.446,575,1614,0.356,2411,5081,0.475,1557,1991,0.782,1007,2404,3411,1607,632,391,1082,1606,8104,0.407134,1
759,2008,Atlanta Hawks*,82,19855,2975,6552,0.454,384,1078,0.356,2591,5474,0.473,1720,2227,0.772,1008,2454,3462,1804,600,448,1223,1673,8054,0.405641,1
760,2008,Seattle SuperSonics,82,19830,3125,7032,0.444,313,939,0.333,2812,6093,0.462,1436,1866,0.77,971,2688,3659,1748,531,400,1310,1680,7999,0.403379,0
761,2008,Detroit Pistons*,82,19730,2999,6551,0.458,487,1330,0.366,2512,5221,0.481,1507,1965,0.767,974,2423,3397,1831,583,472,956,1688,7992,0.405068,1
762,2008,Chicago Bulls,82,19805,2987,6861,0.435,474,1305,0.363,2513,5556,0.452,1533,2029,0.756,1050,2478,3528,1811,635,429,1197,1784,7981,0.402979,0
763,2008,Charlotte Bobcats,82,19880,2960,6554,0.452,529,1443,0.367,2431,5111,0.476,1510,2115,0.714,892,2440,3332,1748,614,402,1204,1777,7959,0.400352,0
764,2008,Milwaukee Bucks,82,19855,3026,6745,0.449,452,1313,0.344,2574,5432,0.474,1452,1980,0.733,1055,2363,3418,1760,544,361,1210,1748,7956,0.400705,0
765,2008,New York Knicks,82,19880,2967,6757,0.439,490,1454,0.337,2477,5303,0.467,1524,2095,0.727,1029,2457,3486,1530,521,213,1187,1761,7948,0.399799,0
766,2008,Houston Rockets*,82,19730,3003,6698,0.448,583,1707,0.342,2420,4991,0.485,1342,1848,0.726,1002,2659,3661,1757,598,420,1125,1609,7931,0.401977,1
767,2008,Philadelphia 76ers*,82,19755,3056,6648,0.46,302,952,0.317,2754,5696,0.483,1509,2137,0.706,1067,2370,3437,1673,712,400,1172,1620,7923,0.401063,1
768,2008,Cleveland Cavaliers*,82,19855,2937,6697,0.439,552,1544,0.358,2385,5153,0.463,1477,2061,0.717,1092,2563,3655,1640,579,427,1145,1712,7903,0.398036,1
769,2008,New Jersey Nets,82,19830,2856,6450,0.443,498,1430,0.348,2358,5020,0.47,1647,2237,0.736,913,2520,3433,1925,521,390,1229,1855,7857,0.396218,0
770,2008,Minnesota Timberwolves,82,19730,3076,6817,0.451,441,1259,0.35,2635,5558,0.474,1246,1693,0.736,964,2428,3392,1630,616,306,1188,1885,7839,0.397314,0
771,2008,Portland Trail Blazers,82,19905,2935,6546,0.448,538,1426,0.377,2397,5120,0.468,1412,1841,0.767,901,2438,3339,1733,455,360,1056,1642,7820,0.392866,0
772,2008,San Antonio Spurs*,82,19730,2938,6424,0.457,594,1610,0.369,2344,4814,0.487,1350,1774,0.761,771,2612,3383,1718,521,337,1035,1537,7820,0.396351,1
773,2008,Los Angeles Clippers,82,19805,2820,6445,0.438,350,1079,0.324,2470,5366,0.46,1702,2178,0.781,800,2491,3291,1732,557,398,1180,1745,7692,0.388387,0
774,2008,Miami Heat,82,19830,2808,6336,0.443,491,1373,0.358,2317,4963,0.467,1384,1903,0.727,743,2342,3085,1644,589,355,1202,1670,7491,0.377761,0
775,2009,Phoenix Suns,82,19755,3373,6695,0.504,553,1445,0.383,2820,5250,0.537,1675,2251,0.744,900,2520,3420,1905,589,420,1288,1691,8974,0.454265,0
776,2009,Golden State Warriors,82,19880,3231,7055,0.458,550,1475,0.373,2681,5580,0.48,1893,2392,0.791,953,2492,3445,1711,638,527,1201,1842,8905,0.447938,0
777,2009,Los Angeles Lakers*,82,19780,3307,6981,0.474,547,1516,0.361,2760,5465,0.505,1607,2087,0.77,1015,2587,3602,1908,718,420,1103,1698,8768,0.443276,1
778,2009,New York Knicks,82,19805,3157,7091,0.445,823,2284,0.36,2334,4807,0.486,1490,1900,0.784,911,2545,3456,1738,610,204,1174,1672,8627,0.435597,0
779,2009,Indiana Pacers,82,19830,3220,7080,0.455,652,1725,0.378,2568,5355,0.48,1525,1890,0.807,924,2661,3585,1775,573,434,1189,1895,8617,0.434544,0
780,2009,Denver Nuggets*,82,19730,3058,6510,0.47,548,1477,0.371,2510,5033,0.499,1891,2487,0.76,905,2507,3412,1820,710,492,1257,1874,8555,0.433604,1
781,2009,Utah Jazz*,82,19880,3143,6623,0.475,392,1122,0.349,2751,5501,0.5,1814,2352,0.771,940,2423,3363,2024,719,374,1210,1830,8492,0.427163,1
782,2009,Chicago Bulls*,82,19930,3126,6846,0.457,493,1293,0.381,2633,5553,0.474,1633,2052,0.796,970,2481,3451,1732,615,453,1192,1709,8378,0.420371,1
783,2009,Dallas Mavericks*,82,19805,3128,6770,0.462,571,1632,0.35,2557,5138,0.498,1516,1852,0.819,909,2595,3504,1779,591,429,1043,1600,8343,0.421257,1
784,2009,Orlando Magic*,82,19730,2929,6416,0.457,817,2147,0.381,2112,4269,0.495,1611,2253,0.715,819,2728,3547,1593,570,439,1142,1664,8286,0.419970,1
785,2009,Boston Celtics*,82,19880,3075,6333,0.486,538,1355,0.397,2537,4978,0.51,1587,2075,0.765,869,2586,3455,1862,621,387,1280,1897,8275,0.416247,1
786,2009,Sacramento Kings,82,19905,2990,6685,0.447,586,1594,0.368,2404,5091,0.472,1682,2107,0.798,840,2366,3206,1619,569,349,1266,1910,8248,0.414368,0
787,2009,Cleveland Cavaliers*,82,19780,3022,6454,0.468,656,1670,0.393,2366,4784,0.495,1523,2012,0.757,886,2574,3460,1663,593,435,1045,1663,8223,0.415723,1
788,2009,Portland Trail Blazers*,82,19830,3018,6494,0.465,596,1555,0.383,2422,4939,0.49,1521,1988,0.765,1060,2360,3420,1667,550,402,1055,1671,8153,0.411145,1
789,2009,Milwaukee Bucks,82,19780,3009,6755,0.445,511,1408,0.363,2498,5347,0.467,1613,2067,0.78,973,2367,3340,1802,609,308,1154,1986,8142,0.411628,0
790,2009,Toronto Raptors,82,19805,3054,6673,0.458,479,1289,0.372,2575,5384,0.478,1534,1861,0.824,802,2513,3315,1835,523,390,1098,1593,8121,0.410048,0
791,2009,Houston Rockets*,82,19805,2959,6526,0.453,621,1656,0.375,2338,4870,0.48,1531,1903,0.805,862,2662,3524,1662,548,355,1158,1553,8070,0.407473,1
792,2009,Miami Heat*,82,19955,3034,6646,0.457,582,1631,0.357,2452,5015,0.489,1411,1871,0.754,828,2411,3239,1671,651,451,1026,1696,8061,0.403959,1
793,2009,Atlanta Hawks*,82,19705,2956,6451,0.458,597,1633,0.366,2359,4818,0.49,1537,2085,0.737,870,2412,3282,1657,603,376,1048,1610,8046,0.408323,1
794,2009,New Jersey Nets,82,19830,2925,6536,0.448,652,1735,0.376,2273,4801,0.473,1542,1980,0.779,850,2415,3265,1636,559,391,1075,1838,8044,0.405648,0
795,2009,Minnesota Timberwolves,82,19805,2986,6766,0.441,543,1539,0.353,2443,5227,0.467,1504,1957,0.769,975,2442,3417,1674,512,322,1165,1785,8019,0.404898,0
796,2009,Philadelphia 76ers*,82,19755,2997,6532,0.459,341,1072,0.318,2656,5460,0.486,1652,2216,0.745,1039,2336,3375,1647,658,415,1157,1650,7987,0.404303,1
797,2009,San Antonio Spurs*,82,19905,3042,6534,0.466,625,1620,0.386,2417,4914,0.492,1249,1641,0.761,728,2638,3366,1736,474,329,963,1546,7958,0.399799,1
798,2009,Oklahoma City Thunder,82,19805,2999,6716,0.447,328,949,0.346,2671,5767,0.463,1626,2069,0.786,999,2497,3496,1663,608,371,1330,1655,7952,0.401515,0
799,2009,Washington Wizards,82,19705,2994,6655,0.45,395,1198,0.33,2599,5457,0.476,1494,1948,0.767,956,2330,3286,1641,619,365,1146,1679,7877,0.399746,0
800,2009,New Orleans Hornets*,82,19755,2911,6366,0.457,556,1526,0.364,2355,4840,0.487,1479,1833,0.807,802,2453,3255,1609,593,338,1029,1665,7857,0.397722,1
801,2009,Los Angeles Clippers,82,19880,2955,6696,0.441,535,1513,0.354,2420,5183,0.467,1354,1839,0.736,890,2377,3267,1723,572,482,1221,1650,7799,0.392304,0
802,2009,Detroit Pistons*,82,19905,2981,6559,0.454,377,1079,0.349,2604,5480,0.475,1388,1849,0.751,949,2448,3397,1689,493,377,973,1712,7727,0.388194,1
803,2009,Memphis Grizzlies,82,19805,2865,6311,0.454,398,1106,0.36,2467,5205,0.474,1570,2077,0.756,847,2337,3184,1423,615,385,1252,1777,7698,0.388690,0
804,2009,Charlotte Bobcats,82,19930,2866,6299,0.455,490,1339,0.366,2376,4960,0.479,1455,1965,0.74,886,2366,3252,1741,580,397,1279,1754,7677,0.385198,0
805,2010,Phoenix Suns*,82,19730,3339,6788,0.492,730,1770,0.412,2609,5018,0.52,1631,2117,0.77,910,2616,3526,1912,479,418,1210,1713,9039,0.458135,1
806,2010,Golden State Warriors,82,19730,3329,7094,0.469,633,1687,0.375,2696,5407,0.499,1631,2085,0.782,753,2397,3150,1839,761,340,1204,1886,8922,0.452205,0
807,2010,Denver Nuggets*,82,19780,3124,6678,0.468,544,1517,0.359,2580,5161,0.5,1937,2508,0.772,889,2505,3394,1719,683,417,1136,1844,8729,0.441304,1
808,2010,Utah Jazz*,82,19755,3227,6575,0.491,439,1207,0.364,2788,5368,0.519,1654,2233,0.741,872,2588,3460,2187,675,400,1246,1859,8547,0.432650,1
809,2010,Toronto Raptors,82,19780,3199,6631,0.482,518,1397,0.371,2681,5234,0.512,1618,2118,0.764,806,2507,3313,1804,469,384,1100,1819,8534,0.431446,0
810,2010,Orlando Magic*,82,19730,3005,6394,0.47,841,2241,0.375,2164,4153,0.521,1575,2176,0.724,810,2736,3546,1615,512,456,1155,1629,8426,0.427065,1
811,2010,Memphis Grizzlies,82,19905,3223,6875,0.469,344,1020,0.337,2879,5855,0.492,1614,2202,0.733,1070,2496,3566,1543,645,399,1248,1655,8404,0.422205,0
812,2010,Houston Rockets,82,19905,3094,6923,0.447,646,1838,0.351,2448,5085,0.481,1561,2022,0.772,971,2471,3442,1790,583,318,1188,1712,8395,0.421753,0
813,2010,New York Knicks,82,19880,3127,6876,0.455,743,2145,0.346,2384,4731,0.504,1376,1759,0.782,836,2477,3313,1772,586,305,1148,1638,8373,0.421177,0
814,2010,Cleveland Cavaliers*,82,19780,3101,6391,0.485,602,1582,0.381,2499,4809,0.52,1569,2180,0.72,791,2692,3483,1835,564,425,1137,1591,8373,0.423306,1
815,2010,Dallas Mavericks*,82,19880,3140,6760,0.464,558,1498,0.372,2582,5262,0.491,1526,1870,0.816,834,2586,3420,1917,624,449,1059,1563,8364,0.420724,1
816,2010,Los Angeles Lakers*,82,19830,3144,6875,0.457,532,1562,0.341,2612,5313,0.492,1519,1985,0.765,973,2662,3635,1730,612,400,1096,1592,8339,0.420524,1
817,2010,Atlanta Hawks*,82,19855,3181,6801,0.468,524,1455,0.36,2657,5346,0.497,1452,1914,0.759,969,2451,3420,1789,592,413,980,1632,8338,0.419945,1
818,2010,Oklahoma City Thunder*,82,19805,3063,6629,0.462,418,1229,0.34,2645,5400,0.49,1778,2210,0.805,960,2607,3567,1639,654,481,1227,1743,8322,0.420197,1
819,2010,San Antonio Spurs*,82,19780,3150,6659,0.473,554,1547,0.358,2596,5112,0.508,1458,1969,0.74,887,2621,3508,1829,516,381,1116,1669,8312,0.420222,1
820,2010,Indiana Pacers,82,19705,3020,6823,0.443,659,1896,0.348,2361,4927,0.479,1564,2019,0.775,785,2618,3403,1730,585,439,1232,1848,8263,0.419335,0
821,2010,New Orleans Hornets,82,19830,3178,6842,0.464,571,1572,0.363,2607,5270,0.495,1293,1661,0.778,852,2450,3302,1828,625,300,1103,1606,8220,0.414523,0
822,2010,Sacramento Kings,82,19880,3144,6895,0.456,482,1383,0.349,2662,5512,0.483,1430,1969,0.726,977,2518,3495,1679,564,366,1226,1827,8200,0.412475,0
823,2010,Boston Celtics*,82,19780,3039,6294,0.483,499,1433,0.348,2540,4861,0.523,1559,2090,0.746,716,2449,3165,1930,701,402,1219,1816,8136,0.411325,1
824,2010,Minnesota Timberwolves,82,19780,3106,6923,0.449,403,1181,0.341,2703,5742,0.471,1436,1926,0.746,962,2556,3518,1626,597,306,1333,1699,8051,0.407027,0
825,2010,Portland Trail Blazers*,82,19855,2974,6453,0.461,491,1388,0.354,2483,5065,0.49,1606,2033,0.79,913,2383,3296,1674,523,350,1012,1715,8045,0.405188,1
826,2010,Philadelphia 76ers,82,19805,3087,6706,0.46,474,1381,0.343,2613,5325,0.491,1366,1808,0.756,941,2421,3362,1723,667,439,1192,1677,8014,0.404645,0
827,2010,Milwaukee Bucks*,82,19980,3050,6998,0.436,645,1813,0.356,2405,5185,0.464,1264,1675,0.755,965,2560,3525,1740,580,385,1085,1823,8009,0.400851,1
828,2010,Chicago Bulls*,82,19905,3081,6825,0.451,352,1066,0.33,2729,5759,0.474,1479,1962,0.754,937,2715,3652,1704,531,478,1175,1648,7993,0.401557,1
829,2010,Miami Heat*,82,19880,2984,6518,0.458,494,1426,0.346,2490,5092,0.489,1452,1931,0.752,875,2553,3428,1548,605,457,1079,1710,7914,0.398089,1
830,2010,Washington Wizards,82,19830,3008,6700,0.449,432,1225,0.353,2576,5475,0.471,1444,1895,0.762,966,2458,3424,1557,493,421,1219,1752,7892,0.397983,0
831,2010,Los Angeles Clippers,82,19705,3002,6601,0.455,483,1457,0.332,2519,5144,0.49,1362,1867,0.73,927,2502,3429,1810,532,466,1285,1581,7849,0.398325,0
832,2010,Charlotte Bobcats*,82,19880,2858,6306,0.453,460,1331,0.346,2398,4975,0.482,1637,2180,0.751,858,2490,3348,1658,632,446,1290,1597,7813,0.393008,1
833,2010,Detroit Pistons,82,19780,2940,6602,0.445,374,1190,0.314,2566,5412,0.474,1455,1998,0.728,1053,2242,3295,1591,596,313,1100,1822,7709,0.389737,0
834,2010,New Jersey Nets,82,19780,2813,6554,0.429,377,1185,0.318,2436,5369,0.454,1572,2015,0.78,897,2358,3255,1540,573,393,1182,1643,7575,0.382963,0
835,2011,Denver Nuggets*,82,19705,3145,6613,0.476,662,1704,0.388,2483,4909,0.506,1859,2429,0.765,791,2652,3443,1813,605,352,1157,1719,8811,0.447145,1
836,2011,New York Knicks*,82,19780,3140,6867,0.457,765,2081,0.368,2375,4786,0.496,1689,2087,0.809,847,2470,3317,1757,625,475,1123,1743,8734,0.441557,1
837,2011,Houston Rockets,82,19880,3170,6975,0.454,677,1843,0.367,2493,5132,0.486,1668,2083,0.801,962,2549,3511,1955,581,371,1110,1641,8685,0.436871,0
838,2011,Phoenix Suns,82,20005,3219,6844,0.47,701,1857,0.377,2518,4987,0.505,1472,1939,0.759,821,2478,3299,1945,545,357,1169,1666,8611,0.430442,0
839,2011,Oklahoma City Thunder*,82,20005,3066,6609,0.464,487,1403,0.347,2579,5206,0.495,1977,2401,0.823,903,2604,3507,1672,654,487,1156,1836,8596,0.429693,1
840,2011,San Antonio Spurs*,82,19780,3148,6628,0.475,685,1727,0.397,2463,4901,0.503,1521,1984,0.767,829,2603,3432,1836,602,372,1101,1556,8502,0.429828,1
841,2011,Golden State Warriors,82,19830,3251,7047,0.461,685,1749,0.392,2566,5298,0.484,1290,1695,0.761,955,2370,3325,1847,737,406,1198,1806,8477,0.427484,0
842,2011,Miami Heat*,82,19780,3031,6301,0.481,547,1479,0.37,2484,4822,0.515,1760,2288,0.769,790,2666,3456,1639,544,430,1142,1674,8369,0.423104,1
843,2011,Los Angeles Lakers*,82,19830,3128,6757,0.463,524,1487,0.352,2604,5270,0.494,1541,1979,0.779,989,2616,3605,1801,602,422,1073,1555,8321,0.419617,1
844,2011,Minnesota Timberwolves,82,19780,3090,7014,0.441,589,1565,0.376,2501,5449,0.459,1519,1977,0.768,1085,2556,3641,1650,592,422,1398,1825,8288,0.419009,0
845,2011,Dallas Mavericks*,82,19705,3069,6463,0.475,645,1768,0.365,2424,4695,0.516,1437,1850,0.777,780,2618,3398,1954,557,352,1145,1575,8220,0.417153,1
846,2011,Memphis Grizzlies*,82,19880,3200,6801,0.471,309,926,0.334,2891,5875,0.492,1486,1981,0.75,970,2391,3361,1691,771,441,1145,1705,8195,0.412223,1
847,2011,Indiana Pacers*,82,19780,3003,6787,0.442,585,1653,0.354,2418,5134,0.471,1592,2035,0.782,914,2657,3571,1611,584,456,1262,1782,8183,0.413701,1
848,2011,Utah Jazz,82,19880,3064,6590,0.465,435,1256,0.346,2629,5334,0.493,1590,2061,0.771,898,2338,3236,1921,629,484,1175,1865,8153,0.410111,0
849,2011,Sacramento Kings,82,19855,3134,6979,0.449,428,1277,0.335,2706,5702,0.475,1455,1981,0.734,1071,2526,3597,1675,608,391,1324,1805,8151,0.410526,0
850,2011,Orlando Magic*,82,19830,2956,6411,0.461,770,2103,0.366,2186,4308,0.507,1453,2101,0.692,864,2679,3543,1636,548,384,1224,1640,8135,0.410237,1
851,2011,Toronto Raptors,82,19780,3144,6755,0.465,345,1091,0.316,2799,5664,0.494,1491,1976,0.755,963,2343,3306,1795,581,350,1206,1807,8124,0.410718,0
852,2011,Philadelphia 76ers*,82,19930,3125,6776,0.461,443,1248,0.355,2682,5528,0.485,1426,1851,0.77,850,2578,3428,1861,621,355,1063,1592,8119,0.407376,1
853,2011,Los Angeles Clippers,82,19855,3015,6594,0.457,513,1519,0.338,2502,5075,0.493,1546,2187,0.707,955,2501,3456,1813,585,402,1343,1733,8089,0.407404,0
854,2011,Chicago Bulls*,82,19830,3042,6587,0.462,511,1415,0.361,2531,5172,0.489,1492,2008,0.743,967,2654,3621,1827,592,468,1161,1639,8087,0.407816,1
855,2011,Washington Wizards,82,19930,3048,6888,0.443,392,1182,0.332,2656,5706,0.465,1489,1999,0.745,1013,2374,3387,1592,665,502,1258,1850,7977,0.400251,0
856,2011,Detroit Pistons,82,19880,3056,6647,0.46,472,1256,0.376,2584,5391,0.479,1367,1854,0.737,931,2236,3167,1730,595,328,1067,1629,7951,0.399950,0
857,2011,Boston Celtics*,82,19780,3023,6219,0.486,408,1119,0.365,2615,5100,0.513,1459,1895,0.77,639,2542,3181,1921,676,344,1195,1678,7913,0.400051,1
858,2011,Portland Trail Blazers*,82,19805,2951,6599,0.447,518,1503,0.345,2433,5096,0.477,1476,1835,0.804,996,2230,3226,1736,660,358,1070,1585,7896,0.398687,1
859,2011,Cleveland Cavaliers,82,19755,2886,6647,0.434,509,1489,0.342,2377,5158,0.461,1546,2075,0.745,856,2449,3305,1720,544,341,1166,1648,7827,0.396203,0
860,2011,Atlanta Hawks*,82,19730,2971,6429,0.462,502,1427,0.352,2469,5002,0.494,1346,1728,0.779,762,2460,3222,1802,497,341,1118,1554,7790,0.394830,1
861,2011,New Orleans Hornets*,82,19830,2944,6416,0.459,444,1232,0.36,2500,5184,0.482,1452,1897,0.765,824,2468,3292,1691,624,359,1069,1719,7784,0.392537,1
862,2011,New Jersey Nets,82,20005,2918,6638,0.44,459,1337,0.343,2459,5301,0.464,1427,1881,0.759,909,2440,3349,1723,458,384,1152,1807,7722,0.386003,0
863,2011,Charlotte Bobcats,82,19805,2873,6365,0.451,393,1203,0.327,2480,5162,0.48,1511,1999,0.756,848,2444,3292,1728,524,433,1192,1637,7650,0.386266,0
864,2011,Milwaukee Bucks,82,19830,2814,6544,0.43,483,1414,0.342,2331,5130,0.454,1423,1881,0.757,862,2480,3342,1545,617,399,1103,1682,7534,0.379929,0
865,2012,Denver Nuggets*,66,16040,2572,5404,0.476,435,1311,0.332,2137,4093,0.522,1293,1760,0.735,738,2105,2843,1581,540,330,1015,1297,6872,0.428429,1
866,2012,San Antonio Spurs*,66,15940,2611,5463,0.478,552,1405,0.393,2059,4058,0.507,1067,1427,0.748,683,2153,2836,1528,490,293,895,1143,6841,0.429172,1
867,2012,Oklahoma City Thunder*,66,15990,2462,5229,0.471,472,1317,0.358,1990,3912,0.509,1406,1744,0.806,726,2157,2883,1224,498,539,1079,1352,6802,0.425391,1
868,2012,Utah Jazz*,66,16165,2523,5531,0.456,273,845,0.323,2250,4686,0.48,1258,1668,0.754,861,2055,2916,1439,545,385,936,1441,6577,0.406867,1
869,2012,Milwaukee Bucks,66,15865,2502,5652,0.443,436,1265,0.345,2066,4387,0.471,1095,1415,0.774,820,1983,2803,1550,548,335,929,1273,6535,0.411913,0
870,2012,Sacramento Kings,66,15915,2490,5712,0.436,411,1301,0.316,2079,4411,0.471,1127,1532,0.736,882,1947,2829,1271,561,323,952,1287,6518,0.409551,0
871,2012,Miami Heat*,66,16040,2446,5212,0.469,370,1030,0.359,2076,4182,0.496,1238,1598,0.775,686,2060,2746,1317,585,355,1002,1282,6500,0.405237,1
872,2012,Phoenix Suns,66,15840,2495,5445,0.458,444,1295,0.343,2051,4150,0.494,1058,1397,0.757,717,2035,2752,1486,431,366,928,1233,6492,0.409848,0
873,2012,Houston Rockets,66,16065,2489,5543,0.449,478,1330,0.359,2011,4213,0.477,1018,1301,0.782,769,2014,2783,1404,496,319,955,1347,6474,0.402988,0
874,2012,Minnesota Timberwolves,66,15940,2355,5434,0.433,473,1423,0.332,1882,4011,0.469,1281,1662,0.771,797,2089,2886,1290,436,293,1001,1212,6464,0.405521,0
875,2012,New York Knicks*,66,15940,2365,5335,0.443,517,1538,0.336,1848,3797,0.487,1211,1634,0.741,743,2012,2755,1328,622,276,1056,1391,6458,0.405144,1
876,2012,Golden State Warriors,66,15915,2489,5443,0.457,524,1351,0.388,1965,4092,0.48,951,1235,0.77,640,1947,2587,1470,528,362,915,1410,6453,0.405467,0
877,2012,Indiana Pacers*,66,15990,2354,5375,0.438,392,1064,0.368,1962,4311,0.455,1349,1724,0.782,826,2070,2896,1228,523,357,925,1430,6449,0.403315,1
878,2012,Los Angeles Clippers*,66,15965,2439,5366,0.455,514,1441,0.357,1925,3925,0.49,1046,1538,0.68,800,1943,2743,1385,556,315,879,1399,6438,0.403257,1
879,2012,Los Angeles Lakers*,66,16065,2429,5319,0.457,362,1112,0.326,2067,4207,0.491,1202,1589,0.756,799,2251,3050,1485,390,351,997,1109,6422,0.399751,1
880,2012,Portland Trail Blazers,66,15965,2402,5417,0.443,478,1382,0.346,1924,4035,0.477,1133,1423,0.796,735,1949,2684,1349,528,322,935,1251,6415,0.401816,0
881,2012,Atlanta Hawks*,66,16165,2429,5348,0.454,492,1330,0.37,1937,4018,0.482,1025,1385,0.74,652,2066,2718,1481,536,303,921,1178,6375,0.394371,1
882,2012,Chicago Bulls*,66,15940,2467,5462,0.452,419,1117,0.375,2048,4345,0.471,1006,1394,0.722,915,2165,3080,1527,456,388,923,1139,6359,0.398934,1
883,2012,Dallas Mavericks*,66,16065,2398,5412,0.443,497,1464,0.339,1901,3948,0.482,1029,1334,0.771,665,2157,2822,1380,565,337,926,1226,6322,0.393526,1
884,2012,Memphis Grizzlies*,66,15940,2425,5422,0.447,277,849,0.326,2148,4573,0.47,1142,1504,0.759,831,1944,2775,1290,631,345,955,1316,6269,0.393287,1
885,2012,Orlando Magic*,66,15965,2275,5162,0.441,670,1785,0.375,1605,3377,0.475,995,1508,0.66,742,2060,2802,1321,451,275,984,1168,6215,0.389289,1
886,2012,Washington Wizards,66,15865,2414,5475,0.441,344,1075,0.32,2070,4400,0.47,1008,1386,0.727,775,1975,2750,1262,527,417,1008,1405,6180,0.389537,0
887,2012,Philadelphia 76ers*,66,15915,2471,5516,0.448,349,963,0.362,2122,4553,0.466,889,1198,0.742,704,2144,2848,1453,526,340,738,1157,6180,0.388313,1
888,2012,New Jersey Nets,66,15890,2262,5320,0.425,507,1481,0.342,1755,3839,0.457,1113,1433,0.777,783,1879,2662,1311,493,260,995,1268,6144,0.386658,0
889,2012,Cleveland Cavaliers,66,15965,2261,5360,0.422,440,1273,0.346,1821,4087,0.446,1178,1645,0.716,841,1949,2790,1308,466,262,1017,1317,6140,0.384591,0
890,2012,Boston Celtics*,66,15940,2341,5086,0.46,363,988,0.367,1978,4098,0.483,1017,1308,0.778,509,2051,2560,1557,498,362,979,1315,6062,0.380301,1
891,2012,Detroit Pistons,66,15965,2291,5232,0.438,317,916,0.346,1974,4316,0.457,1098,1461,0.752,775,1882,2657,1232,460,278,1033,1293,5997,0.375634,0
892,2012,Toronto Raptors,66,15965,2268,5154,0.44,365,1075,0.34,1903,4079,0.467,1085,1410,0.77,697,2074,2771,1382,429,321,1001,1532,5986,0.374945,0
893,2012,New Orleans Hornets,66,15940,2300,5103,0.451,259,777,0.333,2041,4326,0.472,1057,1397,0.757,724,1991,2715,1368,488,316,1024,1324,5916,0.371142,0
894,2012,Charlotte Bobcats,66,15890,2193,5293,0.414,263,892,0.295,1930,4401,0.439,1090,1462,0.746,677,1894,2571,1326,397,361,957,1249,5739,0.361171,0
895,2013,Denver Nuggets*,82,19905,3339,6983,0.478,521,1518,0.343,2818,5465,0.516,1505,2148,0.701,1092,2601,3693,2002,762,533,1253,1682,8704,0.437277,1
896,2013,Houston Rockets*,82,19780,3124,6782,0.461,867,2369,0.366,2257,4413,0.511,1573,2087,0.754,909,2652,3561,1902,679,359,1348,1662,8688,0.439232,1
897,2013,Oklahoma City Thunder*,82,19830,3126,6504,0.481,598,1588,0.377,2528,4916,0.514,1819,2196,0.828,854,2725,3579,1753,679,624,1253,1654,8669,0.437166,1
898,2013,San Antonio Spurs*,82,19880,3210,6675,0.481,663,1764,0.376,2547,4911,0.519,1365,1725,0.791,666,2721,3387,2058,695,446,1206,1427,8448,0.424950,1
899,2013,Miami Heat*,82,19880,3148,6348,0.496,717,1809,0.396,2431,4539,0.536,1423,1887,0.754,676,2490,3166,1890,710,441,1143,1533,8436,0.424346,1
900,2013,Los Angeles Lakers*,82,19755,3041,6640,0.458,715,2015,0.355,2326,4625,0.503,1584,2289,0.692,942,2732,3674,1818,576,429,1232,1467,8381,0.424247,1
901,2013,Golden State Warriors*,82,19805,3130,6840,0.458,658,1632,0.403,2472,5208,0.475,1378,1744,0.79,885,2801,3686,1845,567,346,1236,1753,8296,0.418884,1
902,2013,Dallas Mavericks,82,19980,3182,6892,0.462,606,1628,0.372,2576,5264,0.489,1323,1669,0.793,767,2670,3437,1906,648,454,1144,1698,8293,0.415065,0
903,2013,Los Angeles Clippers*,82,19730,3160,6608,0.478,627,1752,0.358,2533,4856,0.522,1342,1888,0.711,938,2475,3413,1958,784,461,1197,1716,8289,0.420122,1
904,2013,Sacramento Kings,82,19830,3086,6904,0.447,610,1681,0.363,2476,5223,0.474,1437,1869,0.769,943,2385,3328,1708,671,342,1199,1717,8219,0.414473,0
905,2013,New York Knicks*,82,19730,2996,6689,0.448,891,2371,0.376,2105,4318,0.487,1313,1729,0.759,890,2436,3326,1579,672,294,988,1650,8196,0.415408,1
906,2013,Milwaukee Bucks*,82,19830,3128,7197,0.435,601,1670,0.36,2527,5527,0.457,1251,1700,0.736,1068,2537,3605,1876,685,550,1156,1554,8108,0.408875,1
907,2013,Utah Jazz,82,19880,3046,6710,0.454,507,1385,0.366,2539,5325,0.477,1439,1883,0.764,989,2457,3446,1859,690,515,1210,1750,8038,0.404326,0
908,2013,Atlanta Hawks*,82,19855,3084,6644,0.464,706,1901,0.371,2378,4743,0.501,1158,1619,0.715,758,2593,3351,2007,664,369,1219,1473,8032,0.404533,1
909,2013,Portland Trail Blazers,82,19855,3009,6715,0.448,673,1904,0.353,2336,4811,0.486,1304,1680,0.776,874,2474,3348,1784,538,353,1203,1518,7995,0.402669,0
910,2013,Toronto Raptors,82,19980,2979,6685,0.446,571,1665,0.343,2408,5020,0.48,1442,1831,0.788,871,2426,3297,1765,595,392,1124,1836,7971,0.398949,0
911,2013,Brooklyn Nets*,82,19855,2942,6544,0.45,628,1760,0.357,2314,4784,0.484,1432,1958,0.731,1047,2460,3507,1668,599,391,1206,1500,7944,0.400101,1
912,2013,Cleveland Cavaliers,82,19730,2993,6901,0.434,547,1581,0.346,2446,5320,0.46,1380,1826,0.756,1004,2359,3363,1694,647,334,1149,1737,7913,0.401064,0
913,2013,Minnesota Timberwolves,82,19730,2943,6702,0.439,450,1475,0.305,2493,5227,0.477,1515,2042,0.742,973,2473,3446,1836,700,387,1214,1509,7851,0.397922,0
914,2013,Boston Celtics*,81,19840,3001,6459,0.465,498,1390,0.358,2503,5069,0.494,1318,1698,0.776,654,2533,3187,1843,667,365,1181,1717,7818,0.394052,1
915,2013,Phoenix Suns,82,19805,3061,6917,0.443,480,1455,0.33,2581,5462,0.473,1203,1618,0.744,959,2454,3413,1855,659,434,1278,1688,7805,0.394092,0
916,2013,Detroit Pistons,82,19805,2979,6638,0.449,513,1440,0.356,2466,5198,0.474,1307,1870,0.699,991,2463,3454,1742,574,400,1241,1623,7778,0.392729,0
917,2013,Orlando Magic,82,19780,3093,6904,0.448,506,1537,0.329,2587,5367,0.482,1026,1359,0.755,890,2612,3502,1871,528,358,1191,1591,7718,0.390192,0
918,2013,New Orleans Hornets,82,19780,2955,6589,0.448,535,1474,0.363,2420,5115,0.473,1269,1636,0.776,988,2426,3414,1721,520,440,1193,1673,7714,0.389990,0
919,2013,Indiana Pacers*,81,19590,2845,6525,0.436,555,1599,0.347,2290,4926,0.465,1429,1915,0.746,1043,2671,3714,1645,580,513,1227,1623,7674,0.391730,1
920,2013,Charlotte Bobcats,82,19805,2823,6649,0.425,469,1399,0.335,2354,5250,0.448,1546,2060,0.75,917,2389,3306,1587,591,479,1153,1561,7661,0.386822,0
921,2013,Memphis Grizzlies*,82,19805,2964,6679,0.444,382,1107,0.345,2582,5572,0.463,1349,1746,0.773,1059,2445,3504,1715,703,436,1144,1660,7659,0.386721,1
922,2013,Washington Wizards,82,19855,2910,6693,0.435,545,1495,0.365,2365,5198,0.455,1279,1746,0.733,887,2652,3539,1775,598,376,1238,1681,7644,0.384991,0
923,2013,Chicago Bulls*,82,19830,2926,6698,0.437,446,1265,0.353,2480,5433,0.456,1343,1738,0.773,1026,2514,3540,1886,588,417,1171,1617,7641,0.385325,1
924,2013,Philadelphia 76ers,82,19755,3059,6895,0.444,518,1438,0.36,2541,5457,0.466,1004,1377,0.729,896,2493,3389,1867,609,384,1070,1505,7640,0.386738,0
925,2014,Los Angeles Clippers*,82,19755,3208,6761,0.474,693,1966,0.352,2515,4795,0.525,1741,2384,0.73,858,2668,3526,2016,703,397,1136,1767,8850,0.447988,1
926,2014,Houston Rockets*,82,19830,3118,6603,0.472,779,2179,0.358,2339,4424,0.529,1814,2549,0.712,920,2797,3717,1755,621,461,1323,1676,8829,0.445234,1
927,2014,Minnesota Timberwolves,82,19855,3189,7175,0.444,600,1757,0.341,2589,5418,0.478,1790,2301,0.778,1024,2644,3668,1963,718,297,1142,1504,8768,0.441602,0
928,2014,Portland Trail Blazers*,82,19855,3207,7134,0.45,770,2071,0.372,2437,5063,0.481,1569,1926,0.815,1022,2786,3808,1904,454,387,1125,1576,8753,0.440846,1
929,2014,Oklahoma City Thunder*,82,19805,3194,6782,0.471,664,1839,0.361,2530,4943,0.512,1653,2052,0.806,887,2781,3668,1794,678,501,1256,1858,8705,0.439535,1
930,2014,San Antonio Spurs*,82,19755,3326,6844,0.486,698,1757,0.397,2628,5087,0.517,1289,1642,0.785,762,2786,3548,2064,604,420,1180,1495,8639,0.437307,1
931,2014,Phoenix Suns,82,19755,3172,6845,0.463,765,2055,0.372,2407,4790,0.503,1520,2004,0.758,928,2601,3529,1563,688,374,1258,1798,8629,0.436801,0
932,2014,Dallas Mavericks*,82,19830,3249,6858,0.474,721,1877,0.384,2528,4981,0.508,1378,1733,0.795,840,2514,3354,1935,704,356,1110,1636,8597,0.433535,1
933,2014,Denver Nuggets,82,19755,3147,7042,0.447,702,1959,0.358,2445,5083,0.481,1563,2154,0.726,1009,2717,3726,1838,615,459,1305,1890,8559,0.433257,0
934,2014,Golden State Warriors*,82,19830,3236,7005,0.462,774,2037,0.38,2462,4968,0.496,1303,1731,0.753,896,2819,3715,1912,642,407,1247,1784,8549,0.431114,1
935,2014,Los Angeles Lakers,82,19705,3139,6980,0.45,774,2032,0.381,2365,4948,0.478,1390,1835,0.757,745,2620,3365,2006,611,446,1239,1627,8442,0.428419,0
936,2014,Miami Heat*,82,19880,3142,6272,0.501,665,1829,0.364,2477,4443,0.558,1431,1884,0.76,627,2397,3024,1847,732,367,1212,1596,8380,0.421529,1
937,2014,Toronto Raptors*,82,19955,2992,6718,0.445,713,1917,0.372,2279,4801,0.475,1608,2055,0.782,935,2552,3487,1737,577,343,1159,1882,8305,0.416186,1
938,2014,Detroit Pistons,82,19780,3182,7124,0.447,507,1580,0.321,2675,5544,0.483,1415,2111,0.67,1196,2525,3721,1714,687,395,1193,1666,8286,0.418908,0
939,2014,Atlanta Hawks*,82,19830,3061,6688,0.458,768,2116,0.363,2293,4572,0.502,1392,1782,0.781,713,2565,3278,2041,680,326,1251,1577,8282,0.417650,1
940,2014,Washington Wizards*,82,20055,3177,6920,0.459,647,1704,0.38,2530,5216,0.485,1253,1715,0.731,886,2573,3459,1909,668,377,1204,1675,8254,0.411568,1
941,2014,Sacramento Kings,82,19830,3026,6766,0.447,491,1475,0.333,2535,5291,0.479,1698,2237,0.759,990,2656,3646,1547,587,318,1249,1849,8241,0.415582,0
942,2014,New Orleans Pelicans,82,19855,3101,6761,0.459,486,1303,0.373,2615,5458,0.479,1489,1936,0.769,933,2486,3419,1745,647,523,1129,1857,8177,0.411836,0
943,2014,Philadelphia 76ers,82,19855,3108,7150,0.435,577,1847,0.312,2531,5303,0.477,1362,1918,0.71,949,2556,3505,1791,765,330,1384,1844,8155,0.410728,0
944,2014,New York Knicks,82,19855,3027,6739,0.449,759,2038,0.372,2268,4701,0.482,1271,1670,0.761,870,2437,3307,1641,631,367,1063,1815,8084,0.407152,0
945,2014,Brooklyn Nets*,82,19880,2931,6391,0.459,709,1922,0.369,2222,4469,0.497,1508,2002,0.753,721,2407,3128,1714,705,311,1191,1777,8079,0.406388,1
946,2014,Cleveland Cavaliers,82,19930,3036,6955,0.437,584,1640,0.356,2452,5315,0.461,1398,1861,0.751,989,2629,3618,1738,579,304,1163,1640,8054,0.404114,0
947,2014,Charlotte Bobcats*,82,19905,2976,6730,0.442,516,1471,0.351,2460,5259,0.468,1474,2000,0.737,776,2724,3500,1778,499,421,1010,1493,7942,0.398995,1
948,2014,Indiana Pacers*,82,19780,2949,6573,0.449,550,1542,0.357,2399,5031,0.477,1485,1907,0.779,834,2831,3665,1651,550,446,1237,1675,7933,0.401062,1
949,2014,Orlando Magic,82,19955,3022,6784,0.445,563,1596,0.353,2459,5188,0.474,1307,1714,0.763,794,2654,3448,1726,630,350,1222,1678,7914,0.396592,0
950,2014,Boston Celtics,82,19730,2996,6883,0.435,575,1729,0.333,2421,5154,0.47,1325,1706,0.777,980,2505,3485,1726,584,343,1261,1743,7892,0.400000,0
951,2014,Memphis Grizzlies*,82,19805,3122,6723,0.464,405,1147,0.353,2717,5576,0.487,1235,1666,0.741,950,2526,3476,1792,631,375,1124,1568,7884,0.398081,1
952,2014,Milwaukee Bucks,82,19880,2952,6737,0.438,548,1553,0.353,2404,5184,0.464,1377,1843,0.747,971,2399,3370,1760,541,403,1238,1713,7829,0.393813,0
953,2014,Utah Jazz,82,19780,2951,6652,0.444,543,1577,0.344,2408,5075,0.474,1346,1803,0.747,904,2477,3381,1664,570,366,1200,1699,7791,0.393883,0
954,2014,Chicago Bulls*,82,19930,2843,6577,0.432,508,1459,0.348,2335,5118,0.456,1486,1908,0.779,937,2683,3620,1860,594,424,1223,1565,7680,0.385349,1
955,2015,Golden State Warriors*,82,19730,3410,7137,0.478,883,2217,0.398,2527,4920,0.514,1313,1709,0.768,853,2814,3667,2248,762,496,1185,1628,9016,0.456969,1
956,2015,Los Angeles Clippers*,82,19730,3228,6830,0.473,827,2202,0.376,2401,4628,0.519,1468,2067,0.71,784,2711,3495,2031,640,409,1012,1749,8751,0.443538,1
957,2015,Dallas Mavericks*,82,19880,3255,7036,0.463,732,2082,0.352,2523,4954,0.509,1386,1843,0.752,858,2608,3466,1846,663,371,1062,1644,8628,0.434004,1
958,2015,Toronto Raptors*,82,19855,3108,6829,0.455,726,2060,0.352,2382,4769,0.499,1585,2014,0.787,881,2526,3407,1701,615,357,1057,1712,8527,0.429464,1
959,2015,Oklahoma City Thunder,82,19830,3184,7119,0.447,632,1864,0.339,2552,5255,0.486,1524,2020,0.754,1052,2844,3896,1681,598,454,1205,1829,8524,0.429854,0
960,2015,Houston Rockets*,82,19805,3032,6832,0.444,933,2680,0.348,2099,4152,0.506,1525,2133,0.715,958,2624,3582,1820,777,407,1366,1803,8522,0.430295,1
961,2015,San Antonio Spurs*,82,19955,3208,6854,0.468,677,1847,0.367,2531,5007,0.505,1368,1754,0.78,806,2772,3578,2000,657,444,1146,1564,8461,0.424004,1
962,2015,Cleveland Cavaliers*,82,19780,3089,6739,0.458,826,2253,0.367,2263,4486,0.504,1453,1934,0.751,911,2612,3523,1814,603,340,1171,1510,8457,0.427553,1
963,2015,Portland Trail Blazers*,82,19855,3175,7049,0.45,807,2231,0.362,2368,4818,0.491,1272,1589,0.801,879,2881,3760,1799,525,372,1117,1494,8429,0.424528,1
964,2015,Atlanta Hawks*,82,19730,3121,6699,0.466,818,2152,0.38,2303,4547,0.506,1349,1735,0.778,715,2611,3326,2111,744,380,1167,1457,8409,0.426204,1
965,2015,Phoenix Suns,82,19880,3178,7038,0.452,698,2048,0.341,2480,4990,0.497,1343,1767,0.76,896,2643,3539,1659,700,385,1238,1744,8397,0.422384,0
966,2015,Denver Nuggets,82,19880,3099,7158,0.433,660,2032,0.325,2439,5126,0.476,1462,1991,0.734,1012,2653,3665,1788,641,367,1166,1882,8320,0.418511,0
967,2015,Boston Celtics*,82,19880,3193,7211,0.443,660,2021,0.327,2533,5190,0.488,1266,1678,0.754,910,2685,3595,2009,674,294,1133,1738,8312,0.418109,1
968,2015,Sacramento Kings,82,19855,3010,6617,0.455,461,1350,0.341,2549,5267,0.484,1829,2400,0.762,895,2728,3623,1667,550,324,1333,1696,8310,0.418534,0
969,2015,Chicago Bulls*,82,19880,3001,6797,0.442,645,1825,0.353,2356,4972,0.474,1618,2067,0.783,959,2792,3751,1781,514,476,1145,1495,8265,0.415744,1
970,2015,New Orleans Pelicans*,82,19780,3108,6795,0.457,586,1583,0.37,2522,5212,0.484,1345,1790,0.751,942,2621,3563,1806,553,510,1087,1530,8147,0.411881,1
971,2015,Washington Wizards*,82,19955,3139,6790,0.462,497,1381,0.36,2642,5409,0.488,1305,1758,0.742,862,2801,3663,1969,601,378,1233,1707,8080,0.404911,1
972,2015,Detroit Pistons,82,19830,3041,7038,0.432,703,2043,0.344,2338,4995,0.468,1292,1838,0.703,1051,2630,3681,1771,623,383,1099,1559,8077,0.407312,0
973,2015,Los Angeles Lakers,82,19930,3054,7020,0.435,532,1546,0.344,2522,5474,0.461,1433,1935,0.741,952,2647,3599,1715,578,366,1086,1741,8073,0.405068,0
974,2015,Memphis Grizzlies*,82,19905,3097,6763,0.458,423,1246,0.339,2674,5517,0.485,1445,1869,0.773,856,2634,3490,1777,700,347,1094,1567,8062,0.405024,1
975,2015,Brooklyn Nets*,82,19930,3069,6804,0.451,541,1633,0.331,2528,5171,0.489,1359,1817,0.748,846,2627,3473,1716,576,340,1133,1579,8038,0.403312,1
976,2015,Milwaukee Bucks*,82,19930,3083,6722,0.459,545,1500,0.363,2538,5222,0.486,1312,1734,0.757,876,2574,3450,1932,789,403,1373,1814,8023,0.402559,1
977,2015,Minnesota Timberwolves,82,19805,2986,6820,0.438,406,1223,0.332,2580,5597,0.461,1638,2110,0.776,949,2406,3355,1771,668,327,1231,1571,8016,0.404746,0
978,2015,Indiana Pacers,82,19855,2998,6824,0.439,612,1740,0.352,2386,5084,0.469,1373,1817,0.756,856,2822,3678,1757,505,375,1147,1742,7981,0.401964,0
979,2015,Orlando Magic,82,19755,3076,6792,0.453,554,1598,0.347,2522,5194,0.486,1141,1565,0.729,822,2607,3429,1692,647,314,1221,1714,7847,0.397216,0
980,2015,Utah Jazz,82,19705,2900,6492,0.447,610,1781,0.343,2290,4711,0.486,1391,1929,0.721,988,2617,3605,1632,623,489,1256,1583,7801,0.395889,0
981,2015,Miami Heat,82,19730,2885,6330,0.456,556,1659,0.335,2329,4671,0.499,1438,1940,0.741,747,2461,3208,1626,642,372,1214,1636,7764,0.393512,0
982,2015,Charlotte Hornets,82,19905,2913,6932,0.42,498,1566,0.318,2415,5366,0.45,1397,1867,0.748,820,2793,3613,1654,499,448,976,1494,7721,0.387892,0
983,2015,Philadelphia 76ers,82,19805,2765,6777,0.408,692,2160,0.32,2073,4617,0.449,1320,1953,0.676,978,2536,3514,1683,789,487,1453,1778,7542,0.380813,0
984,2015,New York Knicks,82,19855,2882,6726,0.428,560,1614,0.347,2322,5112,0.454,1211,1575,0.769,867,2443,3310,1746,575,382,1206,1768,7535,0.379501,0
985,2016,Golden State Warriors*,82,19880,3489,7159,0.487,1077,2592,0.416,2412,4567,0.528,1366,1790,0.763,816,2972,3788,2373,689,498,1245,1701,9421,0.473893,1
986,2016,Oklahoma City Thunder*,82,19830,3372,7082,0.476,678,1945,0.349,2694,5137,0.524,1616,2067,0.782,1071,2916,3987,1883,603,487,1305,1691,9038,0.455774,1
987,2016,Sacramento Kings,82,19805,3283,7083,0.464,660,1839,0.359,2623,5244,0.5,1514,2089,0.725,868,2760,3628,2009,733,368,1326,1676,8740,0.441303,0
988,2016,Houston Rockets*,82,19830,3094,6847,0.452,878,2533,0.347,2216,4314,0.514,1671,2407,0.694,930,2601,3531,1821,821,430,1307,1790,8737,0.440595,1
989,2016,Boston Celtics*,82,19780,3216,7318,0.439,717,2142,0.335,2499,5176,0.483,1520,1929,0.788,950,2733,3683,1981,752,348,1127,1796,8669,0.438271,1
990,2016,Portland Trail Blazers*,82,19805,3167,7040,0.45,864,2336,0.37,2303,4704,0.49,1424,1889,0.754,948,2782,3730,1748,562,380,1200,1782,8622,0.435345,1
991,2016,Los Angeles Clippers*,82,19830,3141,6759,0.465,797,2190,0.364,2344,4569,0.513,1490,2152,0.692,721,2727,3448,1873,709,460,1063,1746,8569,0.432123,1
992,2016,Cleveland Cavaliers*,82,19855,3171,6888,0.46,880,2428,0.362,2291,4460,0.514,1333,1783,0.748,873,2777,3650,1861,551,317,1114,1666,8555,0.430874,1
993,2016,Washington Wizards,82,19755,3238,7033,0.46,709,1983,0.358,2529,5050,0.501,1349,1849,0.73,743,2688,3431,2005,708,323,1186,1708,8534,0.431992,0
994,2016,San Antonio Spurs*,82,19705,3289,6797,0.484,570,1518,0.375,2719,5279,0.515,1342,1672,0.803,770,2831,3601,2010,677,485,1071,1433,8490,0.430855,1
995,2016,Charlotte Hornets*,82,19855,3036,6922,0.439,873,2410,0.362,2163,4512,0.479,1534,1941,0.79,734,2869,3603,1778,595,438,1030,1487,8479,0.427046,1
996,2016,Atlanta Hawks*,82,19830,3168,6923,0.458,815,2326,0.35,2353,4597,0.512,1282,1638,0.783,679,2772,3451,2100,747,486,1226,1570,8433,0.425265,1
997,2016,New Orleans Pelicans,82,19780,3153,7040,0.448,702,1951,0.36,2451,5089,0.482,1415,1823,0.776,782,2712,3494,1818,633,342,1102,1713,8423,0.425834,0
998,2016,Toronto Raptors*,82,19780,3006,6669,0.451,708,1915,0.37,2298,4754,0.483,1702,2190,0.777,836,2724,3560,1536,636,449,1073,1610,8422,0.425784,1
999,2016,Minnesota Timberwolves,82,19880,3095,6668,0.464,455,1347,0.338,2640,5321,0.496,1753,2213,0.792,821,2587,3408,1916,656,375,1231,1696,8398,0.422435,0
1000,2016,Dallas Mavericks*,82,20005,3064,6900,0.444,806,2342,0.344,2258,4558,0.495,1454,1831,0.794,751,2781,3532,1813,560,306,1047,1595,8388,0.419295,1
1001,2016,Indiana Pacers*,82,19880,3142,6985,0.45,663,1889,0.351,2479,5096,0.486,1430,1872,0.764,847,2779,3626,1741,742,391,1219,1641,8377,0.421378,1
1002,2016,Orlando Magic,82,19905,3242,7120,0.455,636,1818,0.35,2606,5302,0.492,1249,1649,0.757,843,2709,3552,1933,673,417,1155,1701,8369,0.420447,0
1003,2016,Detroit Pistons*,82,19880,3111,7087,0.439,740,2148,0.345,2371,4939,0.48,1399,2095,0.668,1021,2777,3798,1594,573,304,1110,1557,8361,0.420573,1
1004,2016,Denver Nuggets,82,19830,3093,7003,0.442,656,1943,0.338,2437,5060,0.482,1513,1974,0.766,941,2718,3659,1858,609,395,1202,1723,8355,0.421331,0
1005,2016,Chicago Bulls,82,19905,3165,7170,0.441,651,1753,0.371,2514,5417,0.464,1354,1720,0.787,907,2889,3796,1870,495,470,1141,1545,8335,0.418739,0
1006,2016,Phoenix Suns,82,19705,3051,7018,0.435,738,2118,0.348,2313,4900,0.472,1431,1905,0.751,943,2733,3676,1701,632,313,1410,1858,8271,0.419741,0
1007,2016,Miami Heat*,82,19830,3150,6697,0.47,498,1480,0.336,2652,5217,0.508,1406,1889,0.744,807,2811,3618,1709,553,531,1155,1502,8204,0.413717,1
1008,2016,Memphis Grizzlies*,82,19830,3019,6859,0.44,504,1521,0.331,2515,5338,0.471,1584,2024,0.783,916,2497,3413,1697,724,350,1090,1783,8126,0.409783,1
1009,2016,Milwaukee Bucks,82,19830,3145,6740,0.467,440,1277,0.345,2705,5463,0.495,1392,1863,0.747,858,2559,3417,1895,672,475,1247,1695,8122,0.409581,0
1010,2016,Brooklyn Nets,82,19755,3136,6920,0.453,531,1508,0.352,2605,5412,0.481,1286,1699,0.757,863,2614,3477,1829,627,332,1212,1476,8089,0.409466,0
1011,2016,New York Knicks,82,19805,3022,6886,0.439,610,1762,0.346,2412,5124,0.471,1411,1753,0.805,850,2788,3638,1682,467,466,1099,1616,8065,0.407220,0
1012,2016,Utah Jazz,82,19955,2957,6593,0.449,694,1956,0.355,2263,4637,0.488,1402,1885,0.744,880,2665,3545,1555,631,425,1224,1655,8010,0.401403,0
1013,2016,Philadelphia 76ers,82,19805,2970,6887,0.431,764,2255,0.339,2206,4632,0.476,1284,1850,0.694,777,2605,3382,1765,680,495,1343,1780,7988,0.403332,0
1014,2016,Los Angeles Lakers,82,19730,2880,6956,0.414,639,2016,0.317,2241,4940,0.454,1583,2028,0.781,878,2645,3523,1478,593,337,1124,1662,7982,0.404562,0
1015,2017,Golden State Warriors*,82,19780,3532,7140,0.495,982,2562,0.383,2550,4578,0.557,1457,1850,0.788,770,2873,3643,2491,785,555,1211,1585,9503,0.480435,1
1016,2017,Houston Rockets*,82,19780,3305,7152,0.462,1181,3306,0.357,2124,3846,0.552,1667,2177,0.766,892,2746,3638,2070,670,352,1240,1634,9458,0.478160,1
1017,2017,Denver Nuggets,82,19755,3377,7194,0.469,870,2365,0.368,2507,4829,0.519,1537,1986,0.774,966,2837,3803,2077,568,323,1226,1567,9161,0.463731,0
1018,2017,Cleveland Cavaliers*,82,19880,3275,6963,0.47,1067,2779,0.384,2208,4184,0.528,1431,1913,0.748,766,2821,3587,1858,539,327,1121,1486,9048,0.455131,1
1019,2017,Washington Wizards*,82,19855,3388,7137,0.475,756,2030,0.372,2632,5107,0.515,1421,1812,0.784,843,2671,3514,1956,693,336,1162,1745,8953,0.450919,1
1020,2017,Los Angeles Clippers*,82,19755,3242,6820,0.475,841,2245,0.375,2401,4575,0.525,1586,2128,0.745,738,2790,3528,1848,612,347,1062,1626,8911,0.451076,1
1021,2017,Boston Celtics*,82,19755,3168,6978,0.454,985,2742,0.359,2183,4236,0.515,1536,1903,0.807,744,2698,3442,2069,617,340,1088,1686,8857,0.448342,1
1022,2017,Portland Trail Blazers*,82,19930,3243,7059,0.459,852,2272,0.375,2391,4787,0.499,1513,1940,0.78,830,2750,3580,1733,574,408,1126,1736,8851,0.444104,1
1023,2017,Phoenix Suns,82,19830,3270,7260,0.45,615,1854,0.332,2655,5406,0.491,1676,2159,0.776,976,2712,3688,1604,673,399,1265,2030,8831,0.445335,0
1024,2017,Toronto Raptors*,82,19780,3211,6918,0.464,725,1996,0.363,2486,4922,0.505,1615,2028,0.796,871,2676,3547,1517,677,400,1041,1708,8762,0.442973,1
1025,2017,Oklahoma City Thunder*,82,19805,3237,7169,0.452,692,2116,0.327,2545,5053,0.504,1575,2113,0.745,1002,2821,3823,1721,648,408,1230,1715,8741,0.441353,1
1026,2017,Brooklyn Nets,82,19755,3102,6987,0.444,877,2591,0.338,2225,4396,0.506,1592,2020,0.788,721,2879,3600,1756,593,387,1356,1726,8673,0.439028,0
1027,2017,Minnesota Timberwolves,82,19805,3235,6922,0.467,601,1723,0.349,2634,5199,0.507,1586,1986,0.799,938,2540,3478,1940,654,370,1150,1646,8657,0.437112,0
1028,2017,San Antonio Spurs*,82,19805,3222,6864,0.469,753,1927,0.391,2469,4937,0.5,1440,1806,0.797,821,2777,3598,1954,655,484,1101,1498,8637,0.436102,1
1029,2017,Indiana Pacers*,82,19855,3221,6931,0.465,709,1885,0.376,2512,5046,0.498,1467,1811,0.81,742,2702,3444,1844,669,409,1130,1597,8618,0.434047,1
1030,2017,Charlotte Hornets,82,19830,3093,7000,0.442,824,2347,0.351,2269,4653,0.488,1591,1953,0.815,721,2853,3574,1891,571,390,942,1360,8601,0.433737,0
1031,2017,Los Angeles Lakers,82,19705,3224,7164,0.45,730,2110,0.346,2494,5054,0.493,1397,1853,0.754,933,2636,3569,1716,674,320,1243,1698,8575,0.435169,0
1032,2017,New Orleans Pelicans,82,19905,3210,7130,0.45,768,2196,0.35,2442,4934,0.495,1368,1825,0.75,703,2879,3582,1869,638,453,1054,1490,8556,0.429842,0
1033,2017,New York Knicks,82,19855,3244,7256,0.447,704,2022,0.348,2540,5234,0.485,1364,1731,0.788,983,2723,3706,1786,581,455,1139,1668,8556,0.430924,0
1034,2017,Milwaukee Bucks*,82,19780,3182,6715,0.474,720,1946,0.37,2462,4769,0.516,1413,1839,0.768,723,2589,3312,1984,666,436,1145,1660,8497,0.429575,1
1035,2017,Miami Heat,82,19780,3202,7037,0.455,808,2213,0.365,2394,4824,0.496,1248,1768,0.706,872,2705,3577,1742,588,469,1102,1680,8460,0.427705,0
1036,2017,Atlanta Hawks*,82,19880,3123,6918,0.451,729,2137,0.341,2394,4781,0.501,1484,2039,0.728,842,2793,3635,1938,672,397,1294,1491,8459,0.425503,1
1037,2017,Chicago Bulls*,82,19780,3169,7141,0.444,623,1831,0.34,2546,5310,0.479,1474,1848,0.798,999,2797,3796,1851,643,393,1112,1455,8435,0.426441,1
1038,2017,Sacramento Kings,82,19880,3105,6734,0.461,737,1960,0.376,2368,4774,0.496,1483,1913,0.775,715,2652,3367,1844,627,324,1201,1667,8430,0.424044,0
1039,2017,Philadelphia 76ers,82,19830,3088,6992,0.442,831,2443,0.34,2257,4549,0.496,1393,1806,0.771,807,2706,3513,1949,692,420,1366,1793,8400,0.423601,0
1040,2017,Detroit Pistons,82,19805,3269,7282,0.449,631,1915,0.33,2638,5367,0.492,1140,1586,0.719,908,2838,3746,1732,574,310,973,1467,8309,0.419541,0
1041,2017,Orlando Magic,82,19805,3139,7133,0.44,701,2139,0.328,2438,4994,0.488,1309,1753,0.747,807,2734,3541,1820,580,396,1091,1584,8288,0.418480,0
1042,2017,Utah Jazz*,82,19755,3033,6515,0.466,791,2128,0.372,2242,4387,0.511,1401,1875,0.747,771,2774,3545,1651,550,410,1118,1545,8258,0.418021,1
1043,2017,Memphis Grizzlies*,82,19905,2984,6854,0.435,767,2169,0.354,2217,4685,0.473,1504,1918,0.784,886,2621,3507,1744,653,344,1059,1840,8239,0.413916,1
1044,2017,Dallas Mavericks,82,19780,2968,6750,0.44,878,2473,0.355,2090,4277,0.489,1215,1516,0.801,647,2516,3163,1705,614,307,972,1567,8029,0.405915,0
1045,2018,Golden State Warriors*,82,19730,3509,6981,0.503,926,2370,0.391,2583,4611,0.56,1360,1668,0.815,691,2877,3568,2402,656,612,1267,1607,9304,0.471566,1
1046,2018,Houston Rockets*,82,19755,3174,6906,0.46,1256,3470,0.362,1918,3436,0.558,1609,2061,0.781,739,2825,3564,1767,699,392,1135,1597,9213,0.466363,1
1047,2018,New Orleans Pelicans*,82,19955,3500,7241,0.483,837,2312,0.362,2663,4929,0.54,1324,1716,0.772,712,2924,3636,2195,657,485,1223,1570,9161,0.459083,1
1048,2018,Toronto Raptors*,82,19830,3383,7169,0.472,968,2705,0.358,2415,4464,0.541,1422,1790,0.794,800,2807,3607,1995,626,500,1095,1783,9156,0.461725,1
1049,2018,Cleveland Cavaliers*,82,19730,3311,6950,0.476,981,2636,0.372,2330,4314,0.54,1488,1909,0.779,694,2761,3455,1916,582,312,1126,1524,9091,0.460770,1
1050,2018,Denver Nuggets,82,19880,3338,7102,0.47,940,2536,0.371,2398,4566,0.525,1404,1830,0.767,902,2748,3650,2059,627,404,1227,1533,9020,0.453722,0
1051,2018,Philadelphia 76ers*,82,19780,3349,7098,0.472,901,2445,0.369,2448,4653,0.526,1405,1868,0.752,893,2996,3889,2221,682,420,1353,1811,9004,0.455207,1
1052,2018,Minnesota Timberwolves*,82,19805,3365,7063,0.476,658,1845,0.357,2707,5218,0.519,1592,1980,0.804,848,2593,3441,1861,689,345,1021,1495,8980,0.453421,1
1053,2018,Los Angeles Clippers,82,19705,3302,7004,0.471,777,2196,0.354,2525,4808,0.525,1556,2095,0.743,832,2766,3598,1832,628,373,1204,1638,8937,0.453540,0
1054,2018,Charlotte Hornets,82,19780,3197,7106,0.45,824,2233,0.369,2373,4873,0.487,1656,2216,0.747,827,2901,3728,1770,559,373,1041,1409,8874,0.448635,0
1055,2018,Los Angeles Lakers,82,19905,3338,7248,0.461,822,2384,0.345,2516,4864,0.517,1364,1910,0.714,876,2927,3803,1949,633,388,1295,1736,8862,0.445215,0
1056,2018,Oklahoma City Thunder*,82,19830,3271,7221,0.453,881,2491,0.354,2390,4730,0.505,1421,1985,0.716,1024,2671,3695,1750,743,412,1147,1653,8844,0.445991,1
1057,2018,Washington Wizards*,82,19855,3275,7018,0.467,814,2173,0.375,2461,4845,0.508,1378,1786,0.772,823,2713,3536,2065,645,353,1196,1746,8742,0.440292,1
1058,2018,Brooklyn Nets,82,19855,3136,7114,0.441,1041,2924,0.356,2095,4190,0.5,1428,1850,0.772,792,2852,3644,1941,512,390,1245,1688,8741,0.440242,0
1059,2018,Milwaukee Bucks*,82,19830,3257,6807,0.478,718,2024,0.355,2539,4783,0.531,1499,1915,0.783,688,2579,3267,1905,722,443,1134,1752,8731,0.440292,1
1060,2018,Portland Trail Blazers*,82,19755,3222,7132,0.452,845,2308,0.366,2377,4824,0.493,1372,1715,0.8,835,2893,3728,1599,573,423,1109,1599,8661,0.438421,1
1061,2018,Indiana Pacers*,82,19755,3345,7083,0.472,741,2010,0.369,2604,5073,0.513,1225,1573,0.779,788,2684,3472,1819,721,340,1089,1544,8656,0.438168,1
1062,2018,New York Knicks,82,19830,3334,7193,0.464,673,1914,0.352,2661,5279,0.504,1225,1557,0.787,859,2752,3611,1912,552,421,1207,1682,8566,0.431972,0
1063,2018,Utah Jazz*,82,19755,3139,6797,0.462,887,2425,0.366,2252,4372,0.515,1375,1766,0.779,740,2807,3547,1839,708,420,1205,1608,8540,0.432296,1
1064,2018,Boston Celtics*,82,19805,3141,6975,0.45,939,2492,0.377,2202,4483,0.491,1308,1697,0.771,767,2878,3645,1842,604,373,1149,1618,8529,0.430649,1
1065,2018,Phoenix Suns,82,19705,3153,7141,0.442,763,2286,0.334,2390,4855,0.492,1453,1962,0.741,842,2776,3618,1743,569,370,1289,1807,8522,0.432479,0
1066,2018,Detroit Pistons,82,19805,3208,7129,0.45,886,2373,0.373,2322,4756,0.488,1207,1621,0.745,830,2756,3586,1868,628,317,1103,1508,8509,0.429639,0
1067,2018,Miami Heat*,82,19930,3184,6997,0.455,903,2506,0.36,2281,4491,0.508,1209,1601,0.755,763,2801,3564,1862,620,437,1179,1648,8480,0.425489,1
1068,2018,Orlando Magic,82,19730,3182,7042,0.452,844,2405,0.351,2338,4637,0.504,1271,1678,0.757,722,2692,3414,1921,622,400,1192,1579,8479,0.429752,0
1069,2018,Atlanta Hawks,82,19705,3130,7015,0.446,917,2544,0.36,2213,4471,0.495,1298,1654,0.785,743,2693,3436,1946,638,348,1276,1606,8475,0.430094,0
1070,2018,Chicago Bulls,82,19855,3170,7285,0.435,906,2549,0.355,2264,4736,0.478,1194,1574,0.759,790,2873,3663,1923,626,289,1147,1571,8440,0.425082,0
1071,2018,San Antonio Spurs*,82,19730,3202,6999,0.457,696,1977,0.352,2506,5022,0.499,1324,1715,0.772,849,2777,3626,1868,628,460,1078,1408,8424,0.426964,1
1072,2018,Dallas Mavericks,82,19805,3128,7042,0.444,967,2688,0.36,2161,4354,0.496,1167,1530,0.763,666,2717,3383,1858,578,310,1008,1578,8390,0.423630,0
1073,2018,Memphis Grizzlies,82,19705,3013,6788,0.444,758,2152,0.352,2255,4636,0.486,1361,1732,0.786,779,2544,3323,1767,613,396,1227,1900,8145,0.413347,0
1074,2018,Sacramento Kings,82,19755,3179,7063,0.45,738,1967,0.375,2441,5096,0.479,1008,1371,0.735,777,2578,3355,1768,643,340,1125,1639,8104,0.410225,0
